border_size=1
usage=map

Dd, Dd, Dd, Dd, Dd^Es, Ds^Es, Dd^Es, Dd, Dd^Rby, Dd, Xuc, Xuc, Xuc, Xuc, Ss, Ww, Ww, Ss, Ss, Wog, Wog, Wog, Ss, Ss, Ss, Ss, Xuc, Xuc, Xuc, Xuc, Xuc, Xuc, Xuc, Xuc, Xuc, Xuc, Xuc, Xuc, Xuc, Xuc, Xuc
Dd, Dd, Dd^Fts, Dd^Fts, Dd, Dd^Es, Dd, Ss, Ss, Xuc, Ss, Xuc, Ss, Ss, Wwg, Wwg, Wwg, Ww, Ww, Wwg, Ss, Ss, Ss, Ss, Xuc, Xuc, Uu, Xuc, Uu, Uh, Uu, Uu, Uu, Uu, Uu, Xuc, Uu, Xuc, Uu, Xuc, Uu
Dd^Es, Dd, Dd^Es, Dd, Ss, Ss, Chw, Ss, Wwg, Ss, Wwg, Ss, Wwg, Wwg, Ss, Ww^Ewl, Ss, Ww^Vm, Ss, Wwg, Ss, Ss, Xuc, Xuc, Uu, Xuc, Uu, Uu, Uu^Vu, Uu, Ss, Ss, Uu^Uf, Uu, Uu, Uu, Ss, Uu, Ss, Uu, Uu
Dd^Es, Dd^Es, Xuc, Ss, Ss, Ss, Ss, Wwg, Ss, Ss, Ss, Wwg, Ss^Vm, Ss, Uu^Uf, Ss, Ss, Ss, Ss, Ss, Xuc, Xuc, Uu, Xuc, Uu, Uu, Ss, Uu, Uu, Uu, Ss, Uu, Cud, Cud, Cud, Uu, Uu, Ss, Ss, Ss, Uu
Xuc, Dd^Rby, Xuc, Xuc, Xuc, Ss, Xuc, Ss, Urb, Urb, Urb, Ss, Ss, Ss, Ss, Uu, Uu, Chs, Uu, Uu, Xuc, Uu, Uu^Vu, Uu, Ss, Uu^Uf, Ss, Ss, Ss, Ss, Ss, Uu, Cud, 3 Kud, Cud, Uu^Uf, Ss, Ss, Ss, Uu, Uu
Xuc, Xuc, Xuc, Xuc, Wwg, Xuc, Xuc, Ss, Urb, Urb, Ss, Ss, Chs, Ss, Ss, Ss, Ss, Uu, Ss, Uu, Xuc, Uu, Uu, Uu, Ss, Ss, Ss, Ss, Uu, Uu, Uu, Uu, Uu, Cud, Uu, Uu, Uu, Uu, Uu, Uu, Uu
Xuc, Ww^Ewl, Ww^Ewf, Ww^Ewl, Wwg, Wwg, Ss, Ss, Chs, Urb, Urb, Chs, 2 Khs, Chs, Ss, Ss^Vhs, Wwg, Ss, Ss, Uu, Uu, Xuc, Uu, Ss, Ss, Wwg, Ss, Uu, Uu, Ql, Uu, Uu, Uu, Uu, Ql, Uu, Uu, Uu^Vu, Uu, Uu, Ss
Xuc, Ww^Ewl, Ww^Ewl, Ww^Ewl, Xuc, Ss, Chs, Ss, Urb, Urb, Urb, Chs, Chs, Chs, Ss, Wwrg, Wwg, Ss, Chs, Ss, Uu, Xuc, Uu, Uu, Ss, Wwg, Wwg, Ss, Uu, Ql, Ql, Ql, Ql, Ql, Ql, Ql, Uu, Uu, Uu, Ss, Ss
Xuc, Ww^Ewl, Ww^Ewf, Ww^Ewl, Xuc, Ss, Ss, Chs, Urb, Urb, Urb, Urb, Urb, Ss, Ss, Wwg, Wwg, Ss, Ss, Ss, Uu, Xuc, Uu, Ss, Wwg, Wog, Wwg, Ss, Uu, Ql, Ql, Ql, Mm, Mv, Mm, Ql, Ql, Ql, Uu, Uu, Ss
Xuc, Ww^Ewl, Ww^Ewl, Ww^Ewl, Ww^Ewl, Xuc, Ss, Chs, Urb, Urb, Urb, Urb, Urb, Ss, Wwg, Wwg, Ss, Ss, Uu, Uu, Xuc, Xuc, Uu, Ss, Wwf, Wwf, Wwf, Ss, Ss, Uu, Ql, Ql, Ql, Mm, Ql, Ql, Ql, Uu, Uu, Ss, Ss
Xuc, Ww^Ewl, Ww^Ewf, Ww^Ewf, Ww^Ewl, Xuc, Xuc, Ss, Urb, Urb, Urb, Urb, 1 Ss^Kwy, Ss, Ss, Ss, Ss, Uu, Uu^Vu, Uu, Xuc, Uu^Uf, Ss, Ss, Ss, Ss, Ss, Ss, Ss, Uu, Uu, Ql, Ql, Ql, Mv, Ql, Ql, Ql, Uu, Uu, Uu
Xuc, Ww^Ewl, Ww^Ewl, Ww^Ewl, Ww^Ewl, Xuc, Ss, Ss, Urb, Chs, Urb, Ss, Ss, Chs, Chs, Chs, Ss, Uu, Uu, Uu, Xuc, Uu, Ss, Ss, Ss, Uu, Xuc, Ss, Wwf, Ss, Uu, Ql, Ql, Mm, Mm, Mm, Ql, Ql, Uu, Uu^Vu, Uu
Ww^Ewl, Xuc, Ww^Ewf, Ww^Ewl, Xuc, Xuc, Ss, Urb, Ss, Ss, Ss, Urb, Ss, Ss, Ss, Ss, Ss, Uu, Xuc, Xuc, Uu, Uu, Ss, Ss^Vm, Ss, Uu, Xuc, Ss, Wwf, Ss, Ss, Uu, Uu, Ql, Ql, Ql, Ql, Uu, Uu, Uu, Uu
Ww^Ewl, Ww^Ewl, Xuc, Xuc, Uu, Ss, Ss, Urb, Ss, Wwg, Ss, Urb, Ss, Ss, Sm, Sm, Uu, Uu, Xuc, Uu, Ss, Ss, Ss, Ss, Uu, Uu, Xuc, Ss, Ss, Wwf, Ss, Ss, Uu, Ql, Uu, Ql, Uu, Uu, Uu, Xuc, Xuc
Xuc, Xuc, Uu, Uu, Ss, Ss, Ss, Ss, Wwg, Wwg, Ss, Ss, Ss, Ss, Sm, Uu, Uh, Xuc, Uu, Uu, Ss, Wog, Ss, Uu, Xuc, Xuc, Ss, Ss, Ss, Ss, Uu, Ss, Ss, Uu, Sm, Uu, Sm, Sm, Uu, Xuc, Xuc
Uu, Uu, Ss, Uu, Ss, Ss, Wwg, Ss, Wwg, Wwg, Ss, Ss, Wwg, Ss, Ss, Uu, Xuc, Xuc, Ss, Ss, Wwf, Ss, Uu, Uu, Xuc, Uu, Ss, Ss^Vm, Ss, Uu, Xuc, Uu, Uu, Uu, Uu, Uu, Uu, Sm, Uu, Uh, Xuc
Uu, Uu, Ss, Ss, Ss, Ss, Wwg, Wwg, Wwg, Wwrg, Wwg, Wwg, Wwg, Wwg, Ss, Uu, Xuc, Uu, Ss, Wwf, Ss, Ss, Uu, Xuc, Uu, Uu, Ss, Ss, Uu, Uu, Xuc, Xuc, Xuc, Xuc, Xuc, Xuc, Uu, Uu, Uu, Uu, Uu
Uu, Ss, Wwg, Ss^Vhs, Wwg, Wwg, Wwg, Wwg, Wwg, Wwrg, Ss, Wwg, Wwg, Ss, Ss, Xuc, Uu, Uu, Ss, Wwf, Ss, Uu, Xuc, Xuc, Uu, Ss, Ss, Uu, Xuc, Xuc, Uu, Uh, Uu, Uu^Uf, Uu, Uu, Sm, Uu, Uu^Vu, Uu, Uu
Ss, Ss, Wwg, Wwg, Ss, Wwg, Ss, Ss, Ss, Wwf, Ss, Ss, Wwg, Ss, Xuc, Xuc, Ss, Ss, Wwf, Wwf, Ss, Uu, Xuc, Uu, Ss, Ss, Uu, Xuc, Uu^Uf, Uu, Uu, Uu, Sm, Sm, Sm, Sm, Sm, Uu, Uu, Uu, Uu
Wwg, Wwg, Ss, Ss, Uu, Ss, Uu, Ss, Ss, Wwf, Wwf, Ss, Ss, Ss, Ss, Ss, Wwf, Wwf, Ss^Vhs, Ss, Uu, Uu, Xuc, Uu, Ss, Uu, Xuc, Xuc, Sm, Uu, Sm, Xuc, Xuc, Xuc, Xuc, Sm, Xuc, Sm, Xuc, Uu, Xuc
Wwg, Ss, Uu, Ss, Uu, Uu, Ce, Uu, Uu, Ss, Wwf, Ss, Ss, Ss, Ss, Ss, Wwf, Wwg, Wwg, Ss, Uu, Xuc, Uu, Uu, Uu, Uu, Xuc, Ss, Ss, Sm, Ss, Ss, Ss, Dd^Rby, Dd^Es, Xuc, Dd^Es, Xuc, Dd^Es, Xuc, Dd^Es
Ss, Ss, Uu, Uu, Uu^Uf, Ce, 4 Ke, Ce, Uu, Ss, Ss, Wwf, Ss, Ss, Ss, Wwf, Ss, Ss, Ss, Ss, Ss, Uu, Ss, Uu, Uu, Xuc, Ss, Wwf, Ss, Ss, Ss, Dd, Dd, Dd^Es, Dd, Dd, Dd, Dd, Dd, Dd, Dd
Ss, Uu, Uu, Uu, Uu, Ce, Ce, Ce, Uu, Uu, Ss, Wwf, Wwf, Wwf, Wwf, Wwf, Ss, Ss, Uu, Ss, Uu, Ss, Uu, Uu, Xuc, Xuc, Ss, Ww, Ww, Ss, Ss, Ss, Dd, Dd^Fts, Dd, Ww, Ww, Ww, Ww, Ww, Ww
Uu, Uu, Uu^Vu, Uu, Uu, Uu, Uu, Uu, Uu, Ss, Ss^Vm, Ss, Ss, Ss, Ss, Ss, Ss, Uu, Xuc, Uu, Xuc, Uu, Xuc, Xuc, Ss, Ss, Ww, Ww, Ss, Ss, Ss, Dd, Ww, Dd, Ww, Ww, Ww, Wo, Wo, Ww, Wog
Uu, Uu, Uu, Uu, Uu, Uu, Ss, Ss, Ss, Ss, Ss, Ss, Ss, Ss, Uu, Uu, Uu, Uu, Xuc, Xuc, Ss, Xuc, Ss, Xuc, Ss, Ss, Ww, Ss, Ww, Ww, Ww, Ww, Wo, Ww, Wo, Ww, Wo, Wo, Wot, Wo, Wo
Uu, Uu, Uu, Uu, Uu, Uu, Uu, Ss, Ss, Ss, Uu, Uu, Uu, Uu, Xuc, Xuc, Xuc, Xuc, Ss, Ss, Ww, Ss, Ww, Ss, Ww, Ww, Ww, Ww, Ww, Ww, Wo, Wo, Wo, Wo, Wot, Wo, Wot, Wot, Wot, Wot, Wo
