border_size=1
usage=map

Gll^Fp, Gs^Fms, Gs^Fms, Gll^Fp, Gs^Fms, Gs^Fms, Gg, Ww, Ww, Ww, Wo, Wo, Ww, Ww, Ss, Gs^Ftp, Gs, Dd, Dd, Dd^Ftd, Dd^Ftd, Dd, Dd, Dd, Dd, Dd, Dd, Dd, Gs, Gs, Gg, Gg, Gs^Fms, Gs^Fms, Gg, Gg, Gs^Fms, Gs^Fms, Gll^Fp
Gll^Fp, Gs^Fms, Gs^Fms, Gs^Fms, Gs^Fms, Hh^Fms, Gg, Ww, Ww, Ww, Wwr, Ww, Wo, Ww, Ww, Ss, Gs, Dd^Ftd, Dd^Ftd, Dd^Ftd, Dd, Dd^Ftd, Dd^Ftd, Dd, Dd^Ftd, Dd^Ftd, Dd^Ftd, Dd, Dd, Gg, Gg^Ve, Gg, Gs^Fms, Gs^Fms, Gg, Gs^Fms, Gll^Fp, Gs^Fms, Gll^Fp
Gll^Fp, Gs^Fms, Gs^Fms, Gg^Ve, Gs^Fms, Gs^Fms, Gs^Fms, Gg, Ww, Ww, Ww, Wo, Ww, Ww, Ww, Ss, Gg, Gs, Gs^Ftp, Dd, Dd^Ftd, Dd, Dd, Dd, Dd, Dd^Ftd, Dd^Ftd, Dd, Dd, Gs, Gg, Gs^Fms, Gs^Fms, Gg, Gg, Gs^Fms, Gs^Fms, Gs^Fms, Gg
Gll^Fp, Gs^Fds, Gs^Fms, Gg, Gs^Fms, Gs^Fds, Gs^Fms, Gg, Ww, Ww, Ww, 1 Ww, Wwr, Ww, Ss, Ss, Gs^Ftp, Gg^Ve, Gg, Gs^Ftp, Dd^Ftd, Dd, Dd^Ftd, Dd^Ftd, Dd, Dd, Dd, Dd, Gs, Gs, Gs, Gg, Gs, Gs, Gs, Gg, Gs^Fms, Gs^Fms, Gg
Gll^Fp, Gs^Fds, Gs^Fms, Ss, Ss, Gs^Fms, Ss, Ss, Gg, Ww, Ww, Ww, Wwr, Ww, Ww, Ss, Ss, Gs^Ftp, Gs, Gs, Dd^Ftd, Dd, Gg^Ve, Dd^Ftd, Dd^Ftd, Dd, Dd, Dd, Gs^Ft, Hh^Fms, Gs^Fms, Gs^Fms, Gs, 4 Gs, Gs, Gg, Gll^Ftr, Gs^Fms, Gs^Fms
Gs^Fms, Gs^Fms, Gs^Fms, Gs^Fms, Ww, Ww, Gs^Fms, Gg, Gg, Ww, Ww, Ww, Ww, Ww, Ww, Ss, Ss, Ss, Gs, Gs, Dd^Ftd, Dd, Gg^Efm, Gs^Ft, Dd^Ftd, Dd^Ftd, Gs^Ft, Gs^Ft, Hh^Fms, Hh^Fms, Gg, Gg, Gg, Ss, Ss, Ss, Gll^Ftr, Gs^Fms, Gll^Fp
Gs^Fms, Gg^Ve, Gs^Fms, Gs^Fms, Ss, Ww, Gs^Fds, Gs^Fms, Gg, Ss, Ww, Wo, Wo, Wo, Wo, Ww, Ww, Ss, Ss, Gs, Gs^Ftp, Dd^Ftd, Dd^Ftd, Gs^Ft, Gs^Ft, Dd^Ftd, Gs^Ft, Gs^Ft, Hh^Fms, Gs^Fms, Gs^Fms, Gg, Ss, Ss, Ss, Ss, Gll^Ftr, Gs^Fms, Gll^Fp
Gll^Fp, Gs^Fms, Gs^Fms, Gs^Fms, Ss, Gs^Fms, Gll^Fp, Gll^Fp, Ss, Ss, Ss, Ww, Ww, Ww, Ww, Wo, Ww, Ss, Ss, Gs, Gs, Dd^Ftd, Dd^Ftd, Ds^Ftd, Gs^Ft, Gs^Ft, Ww, Gs^Ft, Gs^Fms, Hh^Fms, Gs^Fms, Gg, Gs, Gs, Ww, Gll^Ftr, Gll^Ftr, Gs^Fms, Gg
Gs^Fms, Gll^Fp, Gll^Fp, Ss, Gll^Fp, Gll^Fp, Ss, Ss, Gs^Fms, Ss, Ss, Ww, Ww, Wwr, Wwr, Ww, Wo, Ww, Ss, Ss, Ss, Gs^Ftp, Gg, Gs^Ft, Ss, Ww, Ww, Gs^Ft, Gs^Fds, Hh^Fms, Gs^Fds, Gg, Gg, Gs^Ft, Ww, Ww, Ww, Ww, Ww
Gs^Fms, Gs^Fds, Gll^Fp, Gll^Fp, Gll^Fp, Ss, Gs^Fms, Gs^Fms, Gg^Ve, Gs^Fms, Gs^Fms, Ss, Ww, Ww, Ww, Ww, Ww, Ww, Ss, Ss, Gg, Gg, Gs^Fms, Gs^Fms, Ss, Ss, Ss, Gs^Ft, Gs^Ft, Hh^Fms, Hh^Fds, Gs^Fds, Gg, Gs^Ft, Gs^Fms, Ss, Gg, Gs^Fms, Gll^Fp
Gll^Fp, Gs^Fds, Gll^Fp, Gll^Fp, Gg, Ss, Ss^Bw/, Gg, Gs^Fms, Gs^Fms, Ss, Ss, Ww, Ww, Wo, Ww, Wo, Ww, Ww, Ss, Gg, Gg, Gg, Gll^Fp, Gs^Ftp, Gs^Ftp, Ss, Gs^Ftp, Gs^Ve, Gs^Fds, Hh^Fds, Gs^Fds, Gs^Fms, Gg, Gs^Fms, Ss, Gll^Fp, Gg^Ve, Gg
Gll^Fp, Gll^Fp, Gs^Fms, Gs^Fms, Gg, Gs, Gs^Ftp, Ss, Ss, Ss, Ww, Ss, Ww, Ww, Wo, Wo, Ww, Wo, Ww, Ss, Ss, Gg, Gg, Gs^Fms, Gs^Ftp, Ss, Ss, Ss, Gs^Fms, Gs^Fds, Gg, Gs^Fms, Gg, Gg, Ss, Ss, Gll^Fp, Gg, Gg
Gll^Fp, Gs^Fms, Gg^Ve, Gs^Fms, Gg, Gs^Ftp, Gs^Ftp, Ss, Ss, Ww, Ss, Ww, Ss, Ww, Ww, Ww, Wwr, Ww, Ww, Ss, Ss, Gg, Gg^Efm, Gg, Gs^Fms, Gs^Ftp, Gs^Ftp, Ss, Gs^Fds, Gg, Gs^Fms, Gg, Gs^Fms, Gs^Fms, Ss, Gll^Fp, Gg, Gg, Gg
Gll^Fp, Gs^Fms, Gs^Fms, Gg, Ss, Gg, Gs, Ss, Dd, Cv, Gs^Fms, Gs^Fms, Ss, Ww, Ww, Wwr, Wwr, Ww, Ww, Ss, Gg, Gg, Gg, Gs^Fms, Gs^Fms, Gs^Fms, Gg, Gll^Fp, Gs^Fds, Gs^Fds, Gs^Fms, Gs^Fms, Ss, Ss, Gll^Fp, Gll^Fp, Gg, Gll^Fp, Gll^Fp
Hh^Fms, Gs^Fms, Gll^Fp, Ss, Gll^Fp, Gs^Ftp, Gg, Dd, Dd, Cv, Gs^Fms, Gs^Fms, Ss, Ss, Ww, Ww, Ww, Wo, Ww^Bsb/, Ww^Bsb/, Ss, Ss, Ss, Gg, Gg, Gg, Gs^Fms, Gg, Cv, Cv, Cv, Gs^Fms, Gs^Fms, Ss, Ww, Gg, Gs^Fms, Gs^Fms, Gll^Fp
Hh^Fms, Hh^Fms, Gll^Fp, Gll^Fp, Gll^Fp, Gll^Fp, Gs, Gs^Ftp, Gs^Ftp, Gs^Fms, Gs^Fms, Gs^Fms, Ss, Wwf, Wwf, Wwf, Ww^Bsb/, Wo^Bsb/, Wwr, Ww, Ww, Ss, Ss, Ss, Gg, Gs^Fms, Gg^Efm, Gg, Cv, 3 Kv, Cv, Gs^Fms, Gs^Fms, Gs^Fms, Ww, Gg, Gs^Fms, Gs^Fms, Gll^Fp
Gll^Fp, Gll^Fp, Gs^Fds, Gs^Fms, Gs^Fms, Gs^Fms, Gs^Fms, Gs, Gs, Gg, Gg, Gs^Fms, Gg, Gg, Ww^Bsb/, Wo^Bsb/, Ww, Ww, Wwr, Ww, Wo, Ww, Ss, Gg, Gg, Gs^Fms, Gs^Fms, Gs^Fms, Gs^Fms, Cv, Gg, Gg, Gg^Efm, Gg, Gs^Fms, Ww, Gs^Fms, Gs^Fms, Gll^Fp
Gll^Fp, Gs^Fms, Gs^Fds, Gs^Fms, Gs^Fms, Gs^Fms, Gs^Fms, Gs^Fms, Gs^Fms, Gs^Fms, Gs^Fms, Gg, Gg, Gg, Gg, Wwf, Ww, Ww, Wo, Wo, Wo, Ww, Ww, Ss, Gg, Gs^Fms, Gs^Fms, Gs^Fms, Gs^Fms, Gs^Fms, Gs^Fms, Gg, Ww, Gs^Fms, Ww, Ww, Gs^Fms, Gs^Fms, Gll^Fp
Gs^Fms, Gll^Fp, Gs^Fms, Gs^Fms, Cv, Gs^Fms, Gg, Gs^Fms, Gs^Fms, Gs^Fms, Gg, Gg, Gs^Fms, Gg, Gg, Wwf, Ww, Ww, Ww, Wo, Ww, Ww, Ww, Gg, Gg, Gg, Gs^Fms, Ss, Ss, Ss, Ww, Ww^Bw|, Gs^Fms, Ww, Gs^Fds, Gs^Fms, Gg^Ve, Gs^Fms, Gll^Fp
Gll^Fp, Gs^Fms, Gs^Fms, Cv, 2 Kv, Cv, Gg, Gs^Fms, Gg, Gg^Ve, Gg, Gs^Fms, Gs^Fms, Gs^Fms, Gg, Gg, Gg, Ww, Ww, Wo, Wo, Ww, Ww, Ww, Ss, Gg, Ss, Ss, Gs^Fms, Gs^Fms, Gg, Gg, Gs^Fms, Gs^Fms, Gs^Fds, Gs^Fms, Gs^Fms, Gs^Fms, Gll^Fp
Gs, Gll^Fp, Gs^Fms, Cv, Cv, Cv, Gs^Fms, Gg, Gs^Fms, Gg, Gs^Fms, Gs^Fms, Gs^Fds, Gs^Fms, Gs^Fms, Gs^Fms, Gg, Ww, Ww, Ww, Ww, Wwr, Ww, Ww, Ww, Ss, Gll^Ftr, Ss, Ss, Gs^Fms, Gg^Ve, Gs^Fms, Gs^Fms, Gs^Fds, Gs^Fds, Gs^Fms, Gs^Fms, Gs^Fms, Gll^Fp
Dd, Gs^Ftp, Gs^Ftp, Gs^Fms, Gs^Fms, Gs^Fms, Gs^Fms, Gs^Fms, Gs^Fms, Gs^Fms, Gs^Fms, Gs^Fds, Gs^Fds, Gs^Fms, Gs^Fms, Gs^Fms, Gg, Gg, Ww, Ww, Ww, Wwr, Wwr, Ww, Ww, Gg, Gg, Gg, Ss, Gll^Ftr, Gll^Ftr, Gs^Fms, Gll^Ftr, Gs^Fds, Gll^Ftr, Gs^Fds, Gs^Fms, Gs^Fms, Gll^Fp
Dd, Dd, Gs^Ftp, Gs^Fms, Gs^Fms, Gs^Fms, Gs^Fms, Gs^Fms, Hh^Fms, Gs^Fms, Gs^Fms, Gs^Fds, Gs^Fds, Gs^Fds, Gs^Fms, Gs^Fms, Gs^Fms, Gg, Gg, Ww, Ww, Ww, Wo, Ww, Wo, Ww, Ww, Gg, Gg, Ss, Ss, Gll^Ftr, Wwt, Gll^Ftr, Wwt, Gll^Ftr, Gll^Fp, Gll^Fp, Gll^Fp
Gs^Ftp, Gs^Ftp, Gs^Fms, Gs^Fms, Gs^Fms, Gs^Fms, Gll^Fp, Gll^Fp, Gll^Fp, Gll^Fp, Hh^Fms, Gs^Fds, Gs^Fms, Gs^Fds, Gll^Fp, Gs^Fms, Gs^Fms, Gg, Gg, Ww, Ww, Ww, Wo, Wo, Ww, Ww, Ww, Ss, Ss, Gll^Ftr, Ss, Gll^Ftr, Wwt, Wwt, Wwt, Gll^Ftr, Ss, Gll^Fp, Ss
Gs, Gs^Fms, Gs^Fms, Gs^Fms, Gll^Fp, Gs^Fms, Gll^Fp, Gg^Emf, Gg^Emf, Gg^Emf, Gll^Fp, Gs^Fms, Gs^Fms, Gs^Fms, Gs^Fms, Gs^Fms, Gs^Fms, Gs^Fms, Gg, Gg, Ww, Ww, Ww, Wo, Wo, Wo, Ww, Ww, Gg, Ss, Gll^Ftr, Ss, Gll^Ftr, Wwt, Wwt, Wwt, Gll^Ftr, Ss, Gll^Fp
Gll^Fp, Gs^Fms, Gg^Ve, Gs^Fms, Hh^Fms, Gs^Fms, Hh^Fms, Gg^Emf, Hh^Fms, Hh^Fms, Gs^Fms, Gll^Fp, Gs^Fms, Gs^Fms, Gg^Ve, Gs^Fms, Gs^Fms, Gs^Fms, Gs^Fms, Gg, Gg, Ww, Ww, Wo, Wo, Ww, Ww, Ww, Gg, Gg, Gll^Ftr, Gll^Ftr, Gll^Fp, Gll^Ftr, Gll^Ftr, Gll^Ftr, Gs^Fms, Gll^Fp, Gll^Fp
Gll^Fp, Gs^Fms, Gs^Fms, Gs^Fms, Gll^Fp, Hh^Fms, Gs^Fms, Hh^Fms, Hh^Fms, Hh^Fms, Gs^Fms, Gll^Fp, Gs^Fms, Gs^Fms, Gs^Fms, Gs^Fms, Gs^Fms, Gll^Fp, Gs^Fms, Gg, Gg, Ww, Ww, Ww, Wo, Wo, Ww, Ww, Ww, Gg, Gg, Gll^Ftr, Gg^Efm, Gs^Fms, Gs^Fms, Gg^Ve, Gs^Fms, Gs^Fms, Gll^Fp
Gll^Fp, Gll^Fp, Gll^Fp, Gs^Fms, Hh^Fms, Hh^Fms, Hh^Fms, Gll^Fp, Gll^Fp, Gs^Fms, Gs^Fms, Gs^Fms, Gll^Fp, Gll^Fp, Gll^Fp, Gll^Fp, Gs^Fms, Gs^Fms, Gs^Fms, Gs^Fms, Gg, Ww, Ww, Ww, Ww, Wo, Wo, Ww, Ww, Gg, Gg, Gg, Gll^Fp, Gll^Fp, Gg, Gs^Fms, Gs^Fms, Gs^Fms, Gll^Fp
