border_size=1
usage=map

Xu, Xu, Uu, Ur, Uu, Xu, Xu, Xuc, Xuc, Uu, Ur, Uu, Xu, Mm, Hh^Fms, Ww, Hh^Fms, Hh^Fms, Mm, Mm, Mm, Mm, Mm, Mm, Mm, Mm, Hh^Fms, Hh^Fms, Ss, Ss, Ww, Mm, Mm, Mm
Xu, Uh, Uu, Ur, Uu, Uu, Uu, Uu, Uu, Uu, Ur, Uu^Uf, Xu, Mm, Hh^Fms, Ww, Ww, Hh^Fms, Mm, Mm, Mm, Mm, Mm, Mm, Hh^Fms, Mm, Hh^Fms, Ss, Ss, Ww, Hh^Fms, Mm, Mm, Mm
Uu, Uu, Ur, Ur^Vu, Uu, Uu, Uu, Uu, Uu, Ur, Uu, Uu, Xu, Mm, Hh^Fms, Hh^Es, Ww, Hh^Fms, Hh, Mm, Mm, Mm, Hh^Fms, Hh^Fms, Ww, Hh^Fms, Ww, Ss^Vhs, Ww, Ww, Hh^Fms, Mm, Mm, Mm
Uu, Ur, Uu, Uu, Xuc, Uu, Xu, Xu, Uu, Ur, Uu, Xu, Mm, Mm, Hh^Fms, Ss, Ww, Gs^Vht, Hh^Fms, Hh^Fms, Hh^Fms, Hh^Fms, Hh^Es, Ww, Ss, Ww, Ss, Ww, Ss, Hh^Fms, Mm, Mm, Mm, Mm
Uu, Ur, Uu, Xu, Uu, Xu, Xu, Uh, Uu, Uu, Uu^Vu, Xu, Mm, Hh^Fms, Ss, Ww, Hh^Es, Ww, Ww, Ww, Ww, Ww, Ww, Ww, Ww^Ewl, Ss, Ww^Ewl, Ss, Hh^Fms, Hh^Fms, Mm, Mm, Mm, Hh^Fms
Uu, Ur, Uu, Xuc, Uu, Uu, Xu, Uu, Uu, Xu, Xu, Xu, Mm, Hh^Fms, Ww, Ww, Hh^Fms, Hh^Fms, Hh^Fms, Wwf^Rby, Hh^Fms, Hh^Es, Hh^Fms, Ss, Ww^Ewf, Ww^Ewl, Ww^Ewl, Ss, Hh^Fds, Mm, Mm, Mm, Mm, Hh^Fms
Ur, Ur, Uu, Xu, Uu, Uh, Xu, Uu, Uu, Uh, Mm, Mm, Hh^Fms, Hh, Ww, Hh^Fms, Mm, Mm, Hh^Fms, Ss, Hh^Fms, Mm, Hh^Fms, Ss, Ss, Ss, Ss, Ss, Hh^Fms, Mm, Mm, Mm, Hh^Fds, Hh^Fms
Uu, Uu, Uu^Uf, Xu, Uu, Uu, Uu, Xu, Xu, Xuc, Hh, Hh, Ss, Ww, Hh, Mm, Mm, Mm, Hh^Fms, Gs, Gs, Hh^Fms, Mm, Hh^Fms, Hh^Fms, Hh^Fms, Hh^Fms, Ss, Ss^Bw/, Hh^Fms, Hh^Fds, Mm, Hh^Vhh, Mm
Uu, Uu, Uu, Uu, Uu, Uu, Uu, Xu, Mm, Mm, Hh^Fms, Gs, Ww, Ww, Hh^Fms, Mm, Hh^Fds, Hh^Fms, Gs, Gs, Gs, Hh^Fms, Hh^Fms, Mm, Hh^Fms, Mm, Mm, Hh^Fms, Hh^Fms, Ss, Ss, Hh^Fms, Ss, Hh^Fms
Xu, Uu, Uu^Vu, Uu, Xu, Uu, Xu, Xu, Mm, Hh^Fds, Gs, Ss, Ww, Hh^Fds, Hh^Fms, Hh^Fms, Gs, Gs, Gs, Dd^Es, Dd^Es, Gs, Gs, Hh, Gs, Hh^Fms, Hh^Fms, Mm, Hh^Fms, Ss, Ss, Ss, Ss, Hh^Fms
Xu, Uu, Uu, Uu, Xu, Qxua, Xu, Mm, Hh^Fds, Hh^Fds, Ss, Ww^Bw\, Gs, Hh^Fms, Hh^Vht, Gs, Gs^Es, Gs, Hh, Hh, Hh, Gs^Es, Gs^Es, Gs, Gs, Gs, Hh^Fms, Mm, Mm, Hh^Fms, Hh^Fms, Ss, Ss, Ss
Xu, Uu^Uf, 3 Ke, Ce, Xu, Xu, Mm, Mm, Hh^Fds, Gs, Ss, Ww, Ss, Hh^Fms, Hh^Fms, Gs, Gs, Gs, Ce, Ce, Ce, Gs, Gs^Es, Gs^Es, Gs, Hh, Mm, Hh^Fms, Mm, Mm, Hh^Fms, Hh, Ss, Ss
Mm, Xu, Ce, Xu, Mm, Mm, Hh^Fms, Hh^Fds, Gs, Gs, Ss, Ww, Ss, Hh^Fms, Hh^Fms, Gs, Gs, Hh, Ce, 2 Ke, Ce, Gs, Gs^Es, Gs, Hh, Hh, Mm, Mm, Mm, Hh^Fms, Hh^Fms, Ss, Hh, Mm
Hh^Fms, Mm, Hh^Fms, Mm, Hh^Fms, Hh^Fms, Gs, Hh^Fms, Gs, Ss, Ww, Ww, Hh, Hh^Fms, Gs, Gs, Gs, Hh, Gs, Ce, Gs, Gs, Gs, Gs, Hh^Fms, Mm, Hh^Fms, Hh^Fms, Hh^Fms, Hh^Fms, Hh^Fms, Ss, Hh^Fms, Mm
Gs, Hh^Fms, Gs^Vhs, Hh^Fms, Gs, Gs, Ss, Gs, Ss, Ss, Ww, Ww, Gs, Gs, Gs, Gs^Es, Gs^Es, Gs, Gs^Es, Gs, Gs, Gs, Hh, Hh, Mm, Hd, Hh^Fms, Hd, Hh, Dd^Es, Dd^Ftd, Ss, Mm, Hh^Fms
Ww, Gs, Ww, Gs, Ww, Ss, Ww, Ss, Ww, Ww, Gs, Ww, Gs, Gs, Wwg^Ewl, Gs, Gs, Gs, Hh, Gs^Es, Gs, Gs, Hh^Fms, Mm, Hh^Fms, Hh^Fms, Hh^Es, Mm, Hh^Es, Hd, Hh^Es, Ss^Vhs, Mm, Mm
Ww, Ww, Ww, Ww, Ww, Ww, Ss, Ww, Ss, Ww, Ww, Gs, Gs, Wwg^Ewl, Wwg, Wwg^Ewl, Gs, Gs, Hh, Hh, Gs, Hh, Mm, Hh^Fms, Hh, Hh, Dd^Es, Dd^Es, Dd^Es, Hd, Hd, Hh^Es, Hh, Mm
Wo, Ww, Wwr, Ww, Ww, Ww, Ww, Ww, Ww, Ww, Ww, Gs, Gs, Ss, Ss, Wwg, Wwg^Ewl, Gs, Gs, Gs, Hh, Hh, Mm, Mm, Hh, Dd^Es, Hh, Hh^Es, Hh^Es, Dd, Dd^Es, Dd^Es, Hh, Mm
Wot, Wo, Wo, Wwr, Wo, Ww, Wo, Wwr, Wwr, Ww, Ww, Gs, Ww, Gs, Gs, Ss, Gs, Gs, Gs^Es, Gs, Gs, Hh^Fms, Hh, Mm, Hh, Hh, Hh, Hh, Dd, Dd, Dd, Dd^Es, Hh, Mm
Wo, Wot, Wot, Wo, Wo, Wo, Wo, Wo, Wwr, Wwr, Ww, Ww, Ww, Gs, Ww, Gs, Gs, Gs, Gs, Gs^Es, Gs, Hh, Hh, Hh^Fms, Hh^Fms, Mm, Hh, Dd^Es, Dd, Dd, Dd, Dd^Es, Dd, Hh
Ww, Wo, Wo, Wot, Wot, Wot, Wot, Wo, Wo, Wo, Wo, Ww, Ww, Ww, Ww, Ww, Ww, Ww, Ww, Gs, Ww, Ww^Ewl, Ww, Ss, Gs, Hh, Gs, Dd, Dd, Dd, Hh, Gs, Gs, Gs
Ww, Wo, Ww, Wo, Wo, Wo, Wo, Wot, Wot, Wo, Wo, Ww, Wwr, Ww, Ww, Ww, Ww, Ww, Ww, Ww, Ww, Ww, Ww, Ww, Ww, Ss, Ww, Chw, Chw, Dd, Dd, Hh, Gs, Gs
Ww, Ww, Ww, Ww, Ww, Ww, Ww, Wo, Wo, Wo, Wot, Wo, Wo, Wwr, Wo, Ww, Wo, Ww, Ww, Ww, Ww, Ww^Vm, Ww, Ww, Ww, Ww, Ww, Ww, Ww, Ww, Ww, Hh, Hh, Hh^Fms
Ww, Ww, Ww, Ww, Ww, Ww^Vm, Ww, Wwr, Wo, Wo, Wo, Wot, Wot, Wo, Wot, Wo, Wot, Wo, Wo, Wo, Wo, Ww, Ww, Ww, Ww, Ww, Ww, Ww, Ww, Ww, Ww, Ww, Ww, Hh
Dd, Ww, Dd, Ww, Ww, Ww, Ww, Ww, Ww, Wo, Ww, Wo, Wo, Wo, Wo, Wot, Wo, Wo, Wo, Wot, Wot, Wo, Ww, Ww, Ww, Ww, Ww, Ww, Ww, Ww, Ww, Ww, Ww, Ww
Dd^Ftd, Dd, Dd^Ftd, Ww, Ww, Ww, Ww, Ww, Ww, Ww, Ww, Ww, Ww, Ww, Ww, Wo, Ww, Wwr, Wwr, Wo, Wot, Wo, Wo, Wo, Wo, Ww, Ww, Ww, Ww, 1 Ww, Ww, Ww, Ww, Ww
Hd, Dd^Ftd, Dd^Ftd, Dd^Ftd, Dd^Ftd, Dd^Ftd, Dd^Ftd, Ww, Ww, Ww, Ww, Ww, Ww, Ww, Ww, Ww, Ww, Ww, Ww, Wo, Wo, Wo, Wot, Wo, Wo, Ww, Wo, Ww, Ww, Ww, Ww, Ww, Ww, Ww
Mm, Hd, Mm, Hd, Hd, Dd^Ftd, Hd, Dd^Ftd, Dd^Ftd, Ww, Ww, Ww, Ww, Ww, Ww, Ww, Ww, Ww, Ww, Ww, Ww, Wo, Wo, Wot, Wo, Wo, Wo, Wo, Wot, Ww, Ww, Ww, Ww, Ww
