border_size=1
usage=map

Hd, Hd, Hd, Hd, Hd, Hd, Hhd, Hhd^Vhhr, Hhd, Hh, Hh, Hh^Fms, Hh^Fms, Gs^Fds, Gs^Fds, Gs^Fds, Gs^Fds, Gs^Fds, Gs, Gs^Fds, Gs^Fds, Ss, Ss, Gs^Fds, Gs^Fds, Gs^Fds, Gs, Gs, Gs, Ss, Ss, Ss^Vhs, Ss, Ss, Gs, Gg, Gs^Fds, Gg, Gs^Fds, Gs^Fds, Gs^Fds, Gg^Ve
Hd, Hd, Dd, Hd, Dd, Hd, Hhd, Hhd, Hhd, Hhd, Hh, Hh, Dd, Gs, Dd, Gs^Fds, Gs, Gs^Fds, Gs^Fds, Gs, Gs^Fds, Gs^Fds, Ss, Gs^Fds, Ss, Gs, Ss, Gs, Ss, Ss, Ss, Ss, Gs, Ss, Gs, Gg, Gg, Gs^Fds, Gs^Fds, Gs^Fds, Gs^Fds, Gs^Fds
Hd, Hd, Dd, Dd, Dd, Dd, Dd, Dd, Dd, Dd, Dd, Dd, Dd, Dd, Dd, Dd, Dd, Dd, Dd, Gs, Dd, Gs, Gs, Ss, Gs, Ss, Gs^Fds, Ss, Ss, Ss, Ss, Gs, Ss, Gs, Gs, Gs, Gg, Gs^Fds, Gg, Gs^Fds, Gs^Fds, Gg
Hd, Dd, Dd, Dd^Vda, Dd, Dd, Dd, Dd, Dd^Dc, Dd, Gs, Gs, Gs, Gs, Dd, Dd, Dd, Dd^Vda, Dd, Gs, Gs, Dd, Dd, Gs, Dd, Gs^Fds, Gs^Fds, Gs^Fds, Ss, Ss, Gs, Gs, Ss, Gs, Ss, Ss, Ss, Gg, Gg, Gs^Fds, Gg, Gg
Hd, Hd, Dd, Dd, Gd, Dd, Cd, Dd, Dd, Dd, Gs, Ss, Ss, Gs, Gs, Gs, Dd, Dd, Dd, Dd, Gs, Gs, Dd, Dd, Dd^Vda, Dd, Gs^Fds, Gs^Fds, Ss, Ss, Ss, Gs, Ss, Ss, Ss, Ss^Vhs, Ss, Gs, Gs, Gs, Gs, Gs
Dd, Dd, Gd, Gd, Gs, Gd, 2 Kd, Dd, Dd^Vda, Gs, Gs, Ss, Chw, Ss, Ss, Gs, Gs, Gs, Gs, Gs, Gs, Dd, Gs^Fds, Dd, Dd, Dd, Gs^Fds, Gs^Fds, Ss, Gs, Gs, Ss, Ss, Ss, Gs, Ss, Ss, Gs, Ww, Ww, Ww, Ww
Gd, Gd, Gs, Gs, Ww, Chw, Chw, Rd, Dd, Gs^Ft, Rd, 3 Kd, Chw, Ww, Ss, Gs, Dd, Dd, Dd, Gs^Fds, Gs^Fds, Gs^Fds, Ss, Gs^Fds, Ss, Ss, Ss, Ss, Gs, Gs, Gs^Fds, Gs^Fds, Gs^Fds, Ss, Ss, Gs, Gs, Gs, Ww, Ww, Wo, Wo
Gd, Gd^Vct, Gs, Ss, Ww, Ss, Rd, Rd, Gs^Ft, Gs^Ft, Rd, Cd, Ss, Ww, Ss, Dd, Dd, Dd^Dr, Dd, Gs, Ss, Ss, Gs, Ss, Ss, Gs^Fds, Gs^Fds, Ss, Gs^Fds, Gs^Fds, Gs^Fds, Gs^Fds, Ss, Ss, Ss, Gs, Ww, Ww, Wo, Ww, Wo, Wo
Gs, Gs, Ss, Ss, Ww, Ss, Ss^Bw/, Rd, Rd, Gs^Ft, Rd, Ss, Ww^Bw\, Ww, Ww, Ss, Dd, Dd, Ss, Gs^Fds, Ss, Gs, Dd, Gs, Gs, Gs^Fds, Gs, Gs^Fds, Ss, Gs^Fds, Ss, Ss, Ww, Ss, Ww, Ww, Ww, Ww, Wo, Wo, Wot, Wot
Gs^Ft, Gs^Ft, Ss, Ss, Ww, Ww, Ww, Ss^Bw/, Ss^Bw/, Rd, Ww^Bw\, Ww^Bw\, Ww, Ww, Ww, Ss, Ss, Gs, Ww, Ss, Gs, Dd, Dd^Vdt, Dd, Dd, Gs, Ss, Ss, Ww, Ss, Ww, Ww, Ww, Ww, Ww, Ww, Wo, Wo, Wo, Wo, Wo, Wot
Gs^Ft, Gs^Ft, Ss^Vhs, Ss, Ss, Ww, Ww, Ww, Ss, Ss, Ww, Ww, Ww, Ww, Ss, Ss, Ss, Gs, Ss, Ss, Gs, Dd, Dd, Dd, Ss, Ss, Ss, Ww, Ww, Ww, Ww, Ww, Ww, Wo, Wo, Wo, Wo, 1 Wo, Wo, Wo, Wot, Wot
Gs^Ft, Gs^Ft, Gs^Ft, Gs^Ft, Gs^Ft, Gs^Ft, Ww, Ww, Gs^Ft, Gs^Ft, Gs^Ft, Ww, Ww, Ss, Gs^Ft, Ss^Vhs, Gs^Ft, Gs^Ft, Ww, Ss, Ss, Ss, Ss, Ss, Ww, Ss, Ww, Ww, Ww, Ww, Ww, Ww, Wo, Wo, Wo, Wo, Wot, Wo, Wot, Wot, Wot, Wot
Ss, Gs^Ft, Ss, Gs^Ft, Ww, Ww, Ss, Gs^Ft, Ss, Gs^Ft, Ss, Ww, Ww, Gs^Ft, Ww, Gs^Ft, Ww, Ww, Ww, Ww, Ww, Ww, Ww, Ww, Ww, Ww, Ww, Ww, Ww, Ww, Ww, Ww, Wo, Wo, Wot, Wo, Wot, Wot, Wot, Wot, Wo, Wo
Ss, Ss, Ww, Ss, Ww, Ww, Ww, Ww, Ww, Ww, Ww, Ww, Ww, Ww, Wo, Ww, Ww, Wo, Ww, Wo, Wo, Ww, Wo, Ww, Ww, Ww, Wo, Ww, Wo, Wo, Wo, Wo, Wo, Wo, Wot, Wot, Wot, Wot, Wot, Wot, Wot, Wo
Ww, Ww, Ww, Ww, Ww, Ww, Ww, Ww, Wwr, Ww, Wwr, Ww, Wwr, Ww, Ww, Ww, Wwr, Ww, Wwr, Ww, Wo, Wo, Wo, Wo, Ww, Ww, Wo, Wo, Wo, Wo, Wo, Wo, Wo, Wot, Wwt, Wwt, Wwt, Wot, Wwt, Wot, Wwt, Wwt
Wo, Wo, Wo, Ww, Wwr, Wwr, Ww, Ww, Wwr, Wwr, Wwr, Wwr, Ww, Ww, Wwr, Wwr, Wwr, Wwr, Wwr, Ww, Wo, Wo, Wot, Wo, Wo, Wo, Wot, Wot, Wot, Wot, Wot, Wo, Wot, Wot, Wwt, Wwt, Wwt, Wwt, Wwt, Wwt, Wwt, Wo
Wo, Wo, Ww, Ww, Wwr, Wwr, Ww, Wwr, Ww, Ww, Ww, Ww, Wo, Ww, Ww, Ww, Ww, Ww, Ww, Ww, Wo, Wo, Wot, Wot, Wot, Wot, Wot, Wot, Wot, Wot, Wwt, Wot, Wwt, Wwt, Wo, Wo, Wo, Wwt, Wwt, Ww^Vm, Wwt, Wo
Wot, Wo, Ww, Wwr, Ww, Wwr, Ww, Ww, Wo, Wo, Wo, Wo, Ww, Wo, Wo, Wo, Ww, Ww^Vm, Ww, Ww, Wo, Wot, Wot, Wot, Wwt, Wot, Wot, Wot, Wwt, Wwt, Dd, Wwt, Wwt, Wwt, Wwt, Wo, Wo, Wwt, Wo, Wwt, Wo, Wo
Wot, Wo, Wo, Ww, Wo, Ww, Wo, Wo, Ww, Wo, Ww, Ww, Dd, Ww, Ww, Ww, Ww, Ww, Ww, Wo, Wot, Wot, Wwt, Wwt, Dd, Wwt, Wwt, Wwt, Dd, Dd, Dd, Dd, Dd, Wwt, Wwt, Wo, Wo, Wo, Ww, Wo, Ww, Ww
Wot, Wo, Ww, Wo, Ww^Vm, Wo, Ww, Ww, Ww, Ww, Ww, Dd, Dd, Dd, Ww, Ww, Wo, Ww, Wo, Wo, Wot, Wot, Wot, Wwt, Wwt, Wwt, Wwt, Wwt, Ss, Dd, Dd, Dd, Ss, Wwt, Wwt, Wwt, Wo, Wo, Ww, Ww, Ww, Ww
Wot, Wo, Wo, Ww, Ww, Ww, Wo, Ww, Wo, Ww, Ww, Ww, Ww, Ww, Ww, Ww, Wo, Wo, Wot, Wot, Wot, Wot, Wot, Wwt, Wot, Wwt, Wot, Wwt, Wwt, Dd, Ss, Ss, Wwt, Wwt, Wwt, Wo, Wo, Ww, Ww, Ss, Ss, Ss
Wwt, Wot, Wot, Wo, Wo, Wo, Wot, Wo, Wo, Wo, Wo, Wo, Wo, Wo, Wo, Wo, Wot, Wot, Wot, Wot, Wot, Wot, Wot, Wot, Wot, Wot, Wot, Wwt, Wwt, Wwt, Wwt, Wwt, Wo, Wo, Wo, Wo, Ww, Ww, Ss, Ss, Ss, Gs^Ft
