border_size=1
usage=map

Hd, Hd, Hd, Hd, Hd, Hd, Hhd, Hhd^Vhhr, Hhd, Hh, Hh, Hh^Fms, Hh^Fms, Gs^Fds, Gs^Fds, Gs^Fds, Gs^Fds, Gs^Fds, Gs, Gs^Fds, Gs^Fds, Ss, Ss, Gs^Fds, Gs^Fds, Gs^Fds, Gs, Gs, Gs, Ss, Ss, Ss^Vhs, Ss, Ss, Gs, Gg, Gs^Fds, Gg, Gs^Fds, Gs^Fds, Gs^Fds, Gg^Ve
Hd, Hd, Dd, Hd, Dd, Hd, Hhd, Hhd, Hhd, Hhd, Hh, Hh, Dd, Gs, Dd, Gs^Fds, Gs, Gs^Fds, Gs^Fds, Gs, Gs^Fds, Gs^Fds, Ss, Gs^Fds, Ss, Gs, Ss, Gs, Ss, Ss, Ss, Ss, Gs, Ss, Gs, Gg, Gg, Gs^Fds, Gs^Fds, Gs^Fds, Gs^Fds, Gs^Fds
Hd, Hd, Dd, Dd, Dd, Dd, Dd, Dd, Dd, Dd, Dd, Dd, Dd, Dd, Dd, Dd, Dd, Dd, Dd, Gs, Dd, Gs, Gs, Ss, Gs, Ss, Gs^Fds, Ss, Ss, Ss, Ss, Gs, Ss, Gs, Gs, Gs, Gg, Gs^Fds, Gg, Gs^Fds, Gs^Fds, Gg
Hd, Dd, Dd, Dd^Vda, Dd, Dd, Dd, Dd, Dd^Dc, Dd, Gs, Gs, Gs, Gs, Dd, Dd, Dd, Dd^Vda, Dd, Gs, Gs, Dd, Dd, Gs, Dd, Gs^Fds, Gs^Fds, Gs^Fds, Ss, Ss, Gs, Gs, Ss, Gs, Ss, Ss, Ss, Gg, Gg, Gs^Fds, Gg, Gg
Hd, Hd, Dd, Dd, Gd, Dd, Cd, Dd, Dd, Dd, Gs, Ss, Ss, Gs, Gs, Gs, Dd, Dd, Dd, Dd, Gs, Gs, Dd, Dd, Dd^Vda, Dd, Gs^Fds, Gs^Fds, Ss, Ss, Ss, Gs, Ss, Ss, Ss, Ss^Vhs, Ss, Gs, Gs, Gs, Gs, Gs
Dd, Dd, Gd, Gd, Gs, Gd, 2 Kd, Dd, Dd^Vda, Gs, Gs, Ss, Chw, Ss, Ss, Gs, Gs, Gs, Gs, Gs, Gs, Dd, Gs^Fds, Dd, Dd, Dd, Gs^Fds, Gs^Fds, Ss, Gs, Gs, Ss, Ss, Ss, Gs, Ss, Ss, Gs, Wwt, Wwt, Wwt, Wwt
Gd, Gd, Gs, Gs, Wwt, Chw, Chw, Rd, Dd, Gs^Ft, Rd, 3 Kd, Chw, Wwt, Ss, Gs, Dd, Dd, Dd, Gs^Fds, Gs^Fds, Gs^Fds, Ss, Gs^Fds, Ss, Ss, Ss, Ss, Gs, Gs, Gs^Fds, Gs^Fds, Gs^Fds, Ss, Ss, Gs, Gs, Gs, Wwt, Wwt, Wwt, Wwt
Gd, Gd^Vct, Gs, Ss, Wwt, Ss, Rd, Rd, Gs^Ft, Gs^Ft, Rd, Cd, Ss, Wwt, Ss, Dd, Dd, Dd^Dr, Dd, Gs, Ss, Ss, Gs, Ss, Ss, Gs^Fds, Gs^Fds, Ss, Gs^Fds, Gs^Fds, Gs^Fds, Gs^Fds, Ss, Ss, Ss, Gs, Wwt, Wwt, Wwt, Wwt, Wwt, Wwt
Gs, Gs, Ss, Ss, Wwt, Ss, Ss^Bw/, Rd, Rd, Gs^Ft, Rd, Ss, Wwt^Bw\, Wwt, Wwt, Ss, Dd, Dd, Ss, Gs^Fds, Ss, Gs, Dd, Gs, Gs, Gs^Fds, Gs, Gs^Fds, Ss, Gs^Fds, Ss, Ss, Wwt, Ss, Wwt, Wwt, Wwt, Wwt, Wwt, Wwt, Wot, Wot
Gs^Ft, Gs^Ft, Ss, Ss, Wwt, Wwt, Wwt, Ss^Bw/, Ss^Bw/, Rd, Wwt^Bw\, Wwt^Bw\, Wwt, Wwt, Wwt, Ss, Ss, Gs, Wwt, Ss, Gs, Dd, Dd^Vdt, Dd, Dd, Gs, Ss, Ss, Wwt, Ss, Wwt, Wwt, Wwt, Wwt, Wwt, Wwt, Wwt, Wwt, Wwt, Wwt, Wwt, Wot
Gs^Ft, Gs^Ft, Ss^Vhs, Ss, Ss, Wwt, Wwt, Wwt, Ss, Ss, Wwt, Wwt, Wwt, Wwt, Ss, Ss, Ss, Gs, Ss, Ss, Gs, Dd, Dd, Dd, Ss, Ss, Ss, Wwt, Wwt, Wwt, Wwt, Wwt, Wwt, Wwt, Wwt, Wwt, Wwt, 1 Wwt, Wwt, Wwt, Wot, Wwt
Gs^Ft, Gs^Ft, Gs^Ft, Gs^Ft, Gs^Ft, Gs^Ft, Wwt, Wwt, Gs^Ft, Gs^Ft, Gs^Ft, Wwt, Wwt, Ss, Gs^Ft, Ss^Vhs, Gs^Ft, Gs^Ft, Wwt, Ss, Ss, Ss, Ss, Ss, Wwt, Ss, Wwt, Wwt, Wwt, Wwt, Wwt, Wwt, Wwt, Wwt, Wwt, Wwt, Wot, Wwt, Wwt, Wot, Wot, Wot
Ss, Gs^Ft, Ss, Gs^Ft, Wwt, Wwt, Ss, Gs^Ft, Ss, Gs^Ft, Ss, Wwt, Wwt, Gs^Ft, Wwt, Gs^Ft, Wwt, Wwt, Wwt, Wwt, Wwt, Wwt, Wwt, Wwt, Wwt, Wwt, Wwt, Wwt, Wwt, Wwt, Wwt, Wwt, Wwt, Wwt, Wot, Wwt, Wot, Wot, Wwt, Wwt, Wwt, Wwt
Ss, Ss, Wwt, Ss, Wwt, Wwt, Wwt, Wwt, Wwt, Wwt, Wwt, Wwt, Wwt, Wwt, Wot, Wwt, Wwt, Wot, Wwt, Wot, Wot, Wwt, Wot, Wwt, Wwt, Wwt, Wot, Wwt, Wot, Wwt, Wot, Wwt, Wot, Wot, Wot, Wot, Wwt, Wwt, Wot, Wot, Wot, Wwt
Wwt, Wwt, Wwt, Wwt, Wwt, Wwt, Wwt, Wwt, Wwrt, Wwt, Wwrt, Wwt, Wwrt, Wwt, Wwt, Wwt, Wwrt, Wwt, Wwrt, Wwt, Wot, Wot, Wot, Wot, Wwt, Wwt, Wot, Wot, Wot, Wot, Wwt, Wwt, Wwt, Wwt, Wwt, Wwt, Wwt, Wwt, Wwt, Wot, Wwt, Wwt
Wwt, Wot, Wot, Wwt, Wwrt, Wwrt, Wwt, Wwt, Wwrt, Wwrt, Wwrt, Wwrt, Wwt, Wwt, Wwrt, Wwrt, Wwrt, Wwrt, Wwrt, Wwt, Wot, Wot, Wwt, Wot, Wwt, Wwt, Wwt, Wwt, Wwt, Wwt, Wwt, Wwt, Wwt, Wwt, Wwt, Wwt, Wwt, Wwt, Wwt, Wwt, Wwt, Wo
Wot, Wot, Wwt, Wwt, Wwrt, Wwrt, Wwt, Wwrt, Wwt, Wwt, Wwt, Wwt, Wot, Wwt, Wwt, Wwt, Wwt, Wwt, Wwt, Wwt, Wwt, Wwt, Wwt, Wwt, Wwt, Wwt, Wwt, Wwt, Wwt, Wwt, Wwt, Wwt, Wwt, Wwt, Wo, Wo, Wo, Wwt, Wwt, Ww^Vm, Wwt, Wo
Wot, Wot, Wwt, Wwrt, Wwt, Wwrt, Wwt, Wwt, Wot, Wot, Wot, Wot, Wwt, Wot, Wot, Wot, Wwt, Wwt, Wwt, Ww^Vm, Wwt, Wwt, Wwt, Wwt, Wwt, Wwt, Wwt, Wwt, Wwt, Wwt, Dd, Wwt, Wwt, Wwt, Wwt, Wo, Wo, Wwt, Wo, Wwt, Wo, Wo
Wot, Wot, Wot, Wwt, Wwt, Wwt, Wwt, Wot, Wwt, Wot, Wwt, Wwt, Dd, Wwt, Wwt, Wwt, Wwt, Wwt, Wwt, Wwt, Wwt, Wwt, Wwt, Wwt, Dd, Wwt, Wwt, Wwt, Dd, Dd, Dd, Dd, Dd, Wwt, Wwt, Wo, Wo, Wo, Ww, Wo, Ww, Ww
Wot, Wot, Wwt, Wwt, Ww^Vm, Wwt, Wwt, Wwt, Wwt, Wwt, Wwt, Dd, Dd, Dd, Wwt, Wwt, Wot, Wwt, Wwt, Wwt, Wwt, Wwt, Wwt, Wwt, Wwt, Wwt, Wwt, Wwt, Ss, Dd, Dd, Dd, Ss, Wwt, Wwt, Wwt, Wo, Wo, Ww, Ww, Ww, Ww
Wot, Wot, Wot, Wwt, Wwt, Wwt, Wot, Wwt, Wot, Wwt, Wwt, Wwt, Wwt, Wwt, Wwt, Wwt, Wot, Wot, Wot, Wot, Wot, Wot, Wot, Wwt, Wwt, Wwt, Wwt, Wwt, Wwt, Dd, Ss, Ss, Wwt, Wwt, Wwt, Wo, Wo, Ww, Ww, Ss, Ss, Ss
Wwt, Wot, Wot, Wot, Wot, Wot, Wot, Wot, Wot, Wot, Wot, Wot, Wot, Wot, Wot, Wot, Wot, Wot, Wot, Wot, Wot, Wot, Wot, Wot, Wot, Wot, Wot, Wwt, Wwt, Wwt, Wwt, Wwt, Wo, Wo, Wo, Wo, Ww, Ww, Ss, Ss, Ss, Gs^Ft