border_size=1
usage=map

Wot, Wot, Wwt, Wot, Wot, Wot, Wwt, Wot, Wot, Wot, Wot, Wot, Wot, Wot, Wot, Wot, Wot, Wot, Wot, Wot, Wot, Wot, Wot, Wot, Wot, Wot, Wot, Wot, Wot, Wot, Wot, Wot, Wot, Wot, Wot, Wot, Wot, Wot, Wot, Wot, Wot
Wot, Wot, Wwt, Wwt, Wwt, Wwt, Wwt, Wwt, Wot, Wot, Wot, Wot, Wot, Wot, Wwt, Wot, Wot, Wot, Wot, Wot, Wot, Wot, Wwt, Wot, Wot, Wot, Wot, Wot, Wot, Wot, Wot, Wot, Wwt, Wot, Wot, Wot, Wot, Wot, Wot, Wot, Wot
Wot, Wwt, Dd^Ftd, Dd^Ftd, Dd^Ftd, Dd^Ftd, Wwt, Wwt, Wwt, Wwt, Wwt, Wot, Wwt, Wwt, Ww^Vm, Wwt, Wot, Wot, Wot, Wot, Wwt, Wwt, Wwt, Wwt, Wwt, Wot, Wwt, Wot, Wwt, Wot, Wot, Wwt, Wwt, Wwt, Wwt, Wot, Wot, Wot, Wot, Wot, Wot
Wot, Wwt, Dd^Ftd, Dd^Edpp, Dd, Dd, Dd, Wwt, Wwt, Wwt, Wwt, Wwt, Wwt, Wwt, Wwt, Wwt, Wot, Wot, Wot, Wot, Wwt, Wwt, Dd, Wwt, Wwt, Wwt, Wwt, Wwt, Wwt, Wwt, Wwt, Wwt, Wwt, Dd, Dd, Wwt^Bw/, Wwt, Wot, Wot, Wot, Wot
Wot, Wwt, Dd, Dd, Dd, Dd^Vdt, Dd, Dd^Ftd, Wwt, Wwt, Wot, Wot, Wot, Wot, Wot, Wot, Wot, Wot, Wot, Wwt, Wwt, Wwt, Dd, Dd, Dd, Dd, Dd, Dd, Dd^Ftd, Wwt, Dd, Wwt, Dd, Dd, Ce, Dd^Ftd, Dd^Ftd, Wwt, Wot, Wot, Wot
Wot, Wwt, Dd, Dd^Vdt, Dd, Dd, Dd^Ftd, Dd^Ftd, Wwt, Wwt, Wot, Wot, Wot, Wot, Wot, Wot, Wot, Wot, Wwt, Wwt, Wwt, Dd, Dd, Dd, Dd^Vdt, Dd, Dd, Dd, Dd, Dd^Ftd, Dd, Wwt, Dd, Ce, 3 Ke, Ce, Dd, Wwt, Wwt, Wot, Wot
Wot, Wwt, Wwt, Dd, Dd^Ftd, Dd^Ftd, Dd^Ftd, Wwt, Wwt, Wot, Wot, Wot, Wwrt, Wot, Wot, Wot, Wot, Wot, Wwt, Wwt, Dd^Ftd, Dd, Dd, Dd, Dd, Dd, Wwt, Dd, Dd, Dd^Vdt, Dd, Dd, Dd, Ce, Ce, Ce, Dd, Wwt, Wwt, Wot, Wot
Wot, Wot, Wot, Wwt, Wwt, Wwt, Wwt, Wwt, Wot, Wot, Wot, Wot, Wwrt, Wwrt, Wot, Wot, Wot, Wwt, Wwt, Dd^Ftd, Dd^Ftd, Wwt, Wwt, Wwt, Wwt, Wwt, Wwt, Dd, Dd, Dd, Rd, Rd, Rd, Dd, Dd, Dd, Dd, Wwt, Wot, Wot, Wot
Wot, Wot, Wot, Wwt, Wwt, Wot, Wot, Wot, Wot, Wot, Wot, Wwrt, Wot, Wwrt, Wot, Wot, Wot, Wwt, Wwt, Wwt, Wwt, Wwt, Wwrt, Wwrt, Wwrt, Wwrt, Wwt, Dd, Wwrt, Dd, Dd, Rd, Dd, Dd, Wwt, Wwt, Wwt, Wwt, Wot, Wot, Wot
Wot, Wot, Wot, Wot, Wwt, Wwt, Wot, Wot, Wot, Wot, Wot, Wot, Wot, Wot, Wot, Wot, Wot, Wot, Wot, Wwt, Wwt, Wwt, Wwt, Wwrt, Wwt, Wwt, Wwt, Wwt, Wwrt, Wwrt, Dd, Dd, Dd, Wwt, Wwrt, Wwrt, Wwt, Wot, Wot, Wot, Wot
Wot, Wot, Wot, Wwt, Ww^Vm, Wwt, Wwt, Wot, Wot, Wot, Wot, Wot, Wot, Chw, Wot, Wot, Wot, Chw, Wwt, Wwt, Wwt, Chw, Wwt, Wwrt, Wwt, Chw, Wwt, Wwrt, Wwt, Wwrt, Wwrt, Wwrt, Wwt, Wwt, Wwt, Wwrt, Wwt, Wwt, Wot, Wot, Wot
Wot, Wot, Wot, Wwt, Wwt, Wwt, Wwt, Wot, Wot, Wot, Chw, Wot, Wot, Wot, Wot, Wwt, Wot, Wot, Wwt, Wwrt, Wwt, Wwt, Dd, Wwt, Dd, Wwt, Wwt, Wwt, Chw, Wwt, Wwt, Wwt, Wwt, Wwt, Wot, Wwt, Wot, Wot, Wot, Wot, Wot
Wot, Wot, Wot, Wot, Wwt, Wwt, Wwt, Wwt, Wwt, Wwt, Wwt, Wot, Wwt, Wwt, Wwt, Wwt, Wwt, Wwt, Wwrt, Wwrt, Wwrt, Wwt, Dd, Dd, Hd, Dd, Dd, Wwt, Wwt, Wwt, Wot, Wot, Wot, Wot, Wot, Wwt, Wot, Wot, Wot, Wot, Wot
Wot, Wot, Wot, Wot, Wot, Wwt, Wwt, Chw, Wwt, Ds, Dd^Ftd, Wwt, Wwt, Wwrt, Wwt, Wwt, Wwt, Wwt, Wwt, Wwrt, Wwt, Wwt, Wwt, Dd, Rd, Rd, Dd^Ftd, Wwt, Wwt, Wot, Wot, Chw, Wot, Wot, Wot, Wot, Wot, Wot, Wot, Wot, Wot
Wot, Wot, Wot, Wot, Wot, Wwt, Wwt, Wwt, Ds, Dd^Vht, Dd^Ftd, Wwt, Dd, Dd, Dd, Dd, Wwt, Dd, Wwt, Wwt, Wwt, Dd, Wwt, Dd, Dd, Rd, Dd^Ftd, Wwt, Wwt, Wot, Wot, Wot, Wot, Wot, Wot, Wot, Wot, Wot, Wot, Wot, Wot
Wot, Wot, Wot, Wot, Wot, Wwt, Wwt, Wwt, Wwt, Dd^Ftd, Wwt, Wwt, Dd, Hd, Hd, Dd, Dd, Wwt, Chw, Chw, Chw, Wwt, Wot, Wwt, Wwt, Dd, Dd, Dd^Ftd, Wwt, Wwt, Wot, Wot, Wot, Wot, Wot, Wot, Wot, Wot, Wot, Wot, Wot
Wot, Wot, Wot, Wot, Wot, Wot, Wwt, Chw, Wwt, Wwt, Wwrt, Dd, Hd, Rrc, Rrc, Dd, Wwt, Wwt, Chw, 2 Khw, Chw, Wwt, Wwt, Wwt, Dd, Dd, Csz, Dd, Wwt, Wwt, Wot, Chw, Wot, Wot, Wot, Wot, Wwt, Wot, Wot, Wot, Wot
Wot, Wot, Wot, Wot, Wot, Wot, Wwt, Wwt, Wwt, Wwt, Wwrt, Dd, Hd, Rrc, Rrc, Dd, Dd, Wwt, Wwt, Chw, Wwt, Wwt, Wwt, Dd, Dd, Csz, 1 Csz^Ksy, Chw, Wwt, Wot, Wot, Wot, Wot, Wot, Wot, Wot, Wwt, Wwt, Wot, Wot, Wot
Wot, Wot, Ww^Vm, Wot, Wot, Wwt, Wwrt, Wwrt, Wwrt, Wwrt, Dd, Dd, Dd, Rrc, Dd^Ftd, Dd, Wwrt, Wwt, Wot, Wwt, Dd, Dd^Ftd, Dd, Wo, Dd, Csz, Ww^Vm, Chw, Wot, Wot, Wot, Wot, Wot, Wot, Wot, Wot, Wwt, Ww^Vm, Wwt, Wot, Wot
Wot, Wot, Wot, Wwt, Wot, Wwt, Wwrt, Chw, Wwrt, Wwrt, Wwrt, Dd, Wwrt, Dd^Ftd, Wwrt, Wwrt, Wwt, Wwt, Wot, Wwt, Dd, Dd^Vda, Dd, Wwt, Wwt, Dd, Wwt, Wwt, Wot, Wot, Wot, Chw, Wot, Wot, Wot, Wot, Wot, Wot, Wot, Wot, Wot
Wot, Wot, Wot, Wot, Wot, Wwt, Wwt, Wwrt, Wwrt, Wwrt, Chw, Wwrt, Wwrt, Dd, Wwrt, Wwrt, Wwt, Wot, Wot, Wwt, Wwt, Dd, Wwt, Wwt, Wot, Wwt, Wot, Wot, Chw, Wot, Wot, Wot, Wot, Wot, Wot, Wot, Wot, Wot, Wot, Wot, Wot
Wot, Wot, Wot, Wot, Wot, Wot, Wwt, Wwrt, Wwrt, Wwrt, Wwrt, Wwrt, Wwrt, Wwrt, Wwrt, Wwt, Wwt, Wwt, Wwt, Wot, Wot, Wwt, Wot, Wot, Wot, Wot, Wot, Wot, Wot, Wot, Wot, Wot, Wot, Wot, Wot, Wot, Wot, Wot, Wot, Wot, Wot
Wot, Wot, Wot, Wot, Wwt, Wwt, Wwt, Wwrt, Wwrt, Wwrt, Wwrt, Wwrt, Wwrt, Chw, Wwrt, Wwt, Wwt, Chw, Wwt, Wot, Wot, Chw, Wot, Wot, Wot, Chw, Wot, Wot, Wot, Wot, Wot, Wot, Wot, Wot, Wot, Wot, Wot, Wot, Wot, Wot, Wot
Wot, Wot, Wot, Wwt, Dd^Ftd, Wwt, Dd^Ftd, Wwt, Wwrt, Wwrt, Wwt, Wwrt, Wwt, Wwrt, Wwt, Wwt, Wot, Wwt, Wot, Wot, Wot, Wot, Wot, Wot, Wot, Wot, Wot, Wot, Wot, Wot, Wot, Wot, Wot, Wot, Wot, Wot, Wot, Wot, Wot, Wot, Wot
Wot, Wot, Wwt, Wwt, Dd^Ftd, Dd^Ftd, Dd^Ftd, Wwt, Wwt, Wwrt, Wwrt, Wwt, Wot, Wwt, Wot, Wot, Wot, Wot, Wot, Wot, Wot, Wot, Wot, Wot, Wot, Wot, Wot, Wot, Wot, Wot, Wot, Wot, Wwt, Wot, Wwt, Wwt, Wwt, Wot, Wot, Wot, Wot
Wot, Wot, Wwt, Dd^Ftd, Hd, Ds^Vht, Ds, Ds, Wwt, Wwrt, Wwt, Wwt, Wot, Wot, Wot, Wot, Wot, Wot, Wot, Wot, Wot, Wot, Wot, Wot, Wot, Wot, Wot, Wot, Wot, Wot, Wot, Wwt, Dd, Wwt, Dd^Ftd, Dd, Wwt, Wot, Wot, Wot, Wot
Wot, Wot, Wwt, Dd, Dd, Ds^Edpp, Ds^Esd, Ds, Ds, Wwt, Wwt, Wot, Wot, Wot, Wot, Wot, Wwt, Wwt, Ww^Vm, Wwt, Wot, Wot, Wot, Wot, Wot, Wot, Wot, Wot, Wwt, Wwt, Wwrt, Wwrt, Dd, Dd^Ftd, Dd, Dd^Ftd, Dd, Wwt, Wot, Wot, Wot
Wot, Wot, Wwt, Dd, Dd, Ds, 4 Ds^Edp, Ds, Ds, Wwt, Wwt, Wot, Wot, Wot, Wot, Wot, Wot, Wwt, Wwt, Wot, Wot, Wot, Wot, Wot, Wot, Wot, Wwt, Wwt, Dd, Dd, Dd, Wwrt, Dd, Dd^Vht, Dd, Dd^Vht, Dd, Wwt, Wot, Wot, Wot
Wot, Wot, Wot, Wwt, Dd, Dd, Dd, Ds, Dd, Dd^Ftd, Wwt, Wwt, Wot, Wot, Wot, Wot, Wot, Wwt, Wot, Wwt, Wot, Wot, Wot, Wot, Wot, Wot, Wwt, Dd, Dd, Dd^Vdt, Dd, Dd, Dd, Dd, Dd^Ftd, Dd^Ftd, Wwt, Wwt, Wot, Wot, Wot
Wot, Wot, Wot, Wwt, Dd^Ftd, Dd, Dd^Ftd, Dd, Wwt, Wwt^Bw\, Wwt, Wot, Wot, Wot, Wot, Wot, Wot, Wot, Wot, Wot, Wot, Wot, Wot, Wot, Wot, Wwrt, Wwrt, Wwt, Wwt, Dd, Wwt, Wwt, Wwt, Wwt, Wwt, Dd^Ftd, Wwt, Wot, Wot, Wot, Wot
Wot, Wot, Wot, Wwt, Wwt, Wwt, Wwt, Wwt, Wot, Wwt, Wot, Wot, Wot, Wot, Wot, Wot, Wot, Wot, Wot, Wot, Wot, Wot, Wot, Wot, Wot, Wot, Wot, Wot, Wot, Wwt, Wwt, Wot, Wot, Wot, Wot, Wwt, Wot, Wot, Wot, Wot, Wot
Wot, Wot, Wot, Wot, Wot, Wot, Wot, Wot, Wot, Wot, Wot, Wot, Wot, Wot, Wot, Wot, Wot, Wot, Wot, Wot, Wot, Wot, Wot, Wot, Wot, Wot, Wot, Wot, Wot, Wot, Wot, Wot, Wot, Wot, Wot, Wot, Wot, Wot, Wot, Wot, Wot
Wot, Wot, Wot, Wot, Wot, Wot, Wot, Wot, Wot, Wot, Wot, Wot, Wot, Wot, Wot, Wot, Wot, Wot, Wot, Wot, Wot, Wot, Wot, Wot, Wot, Wot, Wot, Wot, Wot, Wot, Wot, Wot, Wot, Wot, Wot, Wot, Wot, Wot, Wot, Wot, Wot
