border_size=1
usage=map

Wot, Wot, Wwt, Wot, Wot, Wot, Wwt, Wot, Wot, Wot, Wot, Wot, Wot, Wot, Wot, Wot, Wot, Wot, Wot, Wot, Wot, Wot, Wot, Wot, Wot, Wot, Wot, Wot, Wot, Wot, Wot, Wot, Wot, Wot, Wot, Wot, Wot, Wot, Wot, Wot, Wot
Wot, Wot, Wwt, Wwt, Wwt, Wwt, Wwt, Wwt, Wot, Wot, Wot, Wot, Wot, Wot, Wot, Wot, Wot, Wot, Wot, Wot, Wot, Wot, Wwt, Wot, Wot, Wot, Wot, Wot, Wot, Wot, Wot, Wot, Wwt, Wot, Wot, Wot, Wot, Wot, Wot, Wot, Wot
Wot, Wwt, Dd^Ft, Dd^Ft, Dd^Ft, Dd^Ft, Dd, Wwt, Wwt, Wwt, Wwt, Wot, Wwt, Wot, Wwt, Wwt^Vm, Wot, Wot, Wot, Wot, Wwt, Wwt, Wwt, Wwt, Wwt, Wot, Wwt, Wot, Wwt, Wot, Wot, Wwt, Wwt, Wwt, Wwt, Wot, Wot, Wot, Wot, Wot, Wot
Wot, Wwt, Dd^Ft, Gs^Ft, Hh^Ft, Gs^Ft, Dd^Vdt, Dd, Wwt, Wwt, Wwt, Wwt, Wwt, Wwt, Wwt, Wwt, Wot, Wot, Wot, Wot, Wwt, Wwt, Gs^Ft, Wwt, Wwt, Wwt, Wwt, Wwt, Wwt, Wwt, Wwt, Wwt, Wwt, Dd, Dd, Wwt^Bw/, Wwt, Wot, Wot, Wot, Wot
Wot, Wwt, Dd, Dd^Es, Hh, Gs^Ft, Gs^Ft, Dd^Ft, Wwt, Wwt, Wot, Wot, Wot, Wot, Wot, Wot, Wot, Wot, Wot, Wwt, Wwt, Wwt, Gs^Ft, Gs^Ft, Gs^Ft, Gs^Ft, Gs^Ft, Gs^Ft, Gs^Ft, Wwt, Dd, Wwt, Dd, Dd, Ce, Gs^Ft, Gs^Ft, Wwt, Wot, Wot, Wot
Wot, Wwt, Dd, Dd^Vdt, Dd^Ft, Hh^Ft, Gs^Ft, Dd^Ft, Wwt, Wwt, Wot, Wot, Wot, Wot, Wot, Wot, Wot, Wot, Wwt, Wwt, Wwt, Dd^Ft, Dd^Ft, Hh^Ft, Hh^Vht, Hh^Ft, Dd^Ft, Hh^Ft, Hh^Ft, Gs^Ft, Dd^Ft, Wwt, Dd, Ce, 3 Ke, Ce, Dd, Wwt, Wwt, Wot, Wot
Wot, Wwt, Wwt, Dd, Dd^Ft, Gs^Ft, Dd^Ft, Wwt, Wwt, Wot, Wot, Wot, Wwrt, Wot, Wot, Wot, Wot, Wot, Wwt, Wwt, Dd^Ft, Dd^Ft, Dd, Dd, Dd, Dd, Wwt, Dd^Ft, Hh^Ft, Hh^Vht, Hh^Ft, Dd^Ft, Dd^Es, Ce, Ce, Ce, Dd, Wwt, Wwt, Wot, Wot
Wot, Wot, Wot, Wwt, Wwt, Wwt, Wwt, Wwt, Wot, Wot, Wot, Wot, Wwrt, Wwrt, Wot, Wot, Wot, Wwt, Wwt, Dd^Ft, Dd^Ft, Wwt, Wwt, Wwt, Wwt, Wwt, Wwt, Dd, Dd, Hh^Ft, Dd, Rd^Es, Rd, Dd, Dd, Dd, Dd, Wwt, Wot, Wot, Wot
Wot, Wot, Wot, Wwt, Wwt, Wot, Wot, Wot, Wot, Wot, Wot, Wwrt, Wot, Wwrt, Wot, Wot, Wot, Wot, Wot, Wwt, Wwt, Wwt, Wwrt, Wwrt, Wwrt, Wwrt, Wwt, Dd, Wwrt, Dd, Dd, Rd^Dr, Dd, Dd, Wwt, Wwt, Wwt, Wwt, Wot, Wot, Wot
Wot, Wot, Wot, Wot, Wwt, Wwt, Wot, Wot, Wot, Wot, Wot, Wot, Wot, Wot, Wot, Wot, Wot, Wot, Wot, Wot, Wwt, Wwt, Wwt, Wwrt, Wwt, Wwt, Wwt, Wwt, Wwrt, Wwrt, Dd, Dd, Dd, Wwt, Wwrt, Wwrt, Wwt, Wot, Wot, Wot, Wot
Wot, Wot, Wot, Wwt, Wwt^Vm, Wwt, Wwt, Wot, Wot, Wot, Wot, Wot, Wot, Chw, Wwt, Wot, Wwt, Chw, Wwt, Wwt, Wwt, Chw, Wwt, Wwrt, Wwt, Chw, Wwt, Wwrt, Wwt, Wwrt, Wwrt, Wwrt, Wwt, Wwt, Wwt, Wwrt, Wwt, Wwt, Wot, Wot, Wot
Wot, Wot, Wot, Wwt, Wwt, Wwt, Wwt, Wot, Wot, Wot, Chw, Wot, Wot, Wot, Wwt, Wwt, Wwt, Wot, Wwt, Wwrt, Wwt, Wwt, Dd, Wwt, Dd, Wwt, Wwt, Wwt, Chw, Wwt, Wwt, Wwt, Wwt, Wwt, Wot, Wwt, Wot, Wot, Wot, Wot, Wot
Wot, Wot, Wot, Wot, Wwt, Wwt, Wwt, Wwt, Wwt, Wwt, Wwt, Wot, Wwt, Wwt, Wwt, Dd^Vhs, Wwt, Wwt, Wwrt, Wwrt, Wwrt, Wwt, Dd^Ft, Gs^Ft, Hh^Ft, Dd, Dd, Wwt, Wwt, Wwt, Wot, Wot, Wot, Wot, Wot, Wwt, Wot, Wot, Wot, Wot, Wot
Wot, Wot, Wot, Wot, Wot, Wwt, Wwt, Chw, Wwt, Dd, Dd^Ft, Wwt, Wwt, Wwrt, Wwt, Wwt, Wwt, Wwt, Wwt, Wwrt, Wwt, Wwt, Wwt, Hh^Ft, Rd, Rd, Gs^Ft, Wwt, Wwt, Wot, Wot, Chw, Wot, Wot, Wot, Wot, Wot, Wot, Wot, Wot, Wot
Wot, Wot, Wot, Wot, Wot, Wwt, Wwt, Wwt, Dd, Dd^Vht, Hh^Ft, Wwt, Gs^Ft, Gs^Ft, Gs^Ft, Gs^Ft, Wwt, Dd, Wwt, Wwt, Wwt, Dd, Wwt, Dd, Dd, Rd, Gs^Ft, Wwt, Wwt, Wot, Wot, Wot, Wot, Wot, Wot, Wot, Wot, Wot, Wot, Wot, Wot
Wot, Wot, Wot, Wot, Wot, Wwt, Wwt, Wwt, Wwt, Dd^Ft, Wwt, Wwt, Dd^Es, Dd^Ft, Hh^Ft, Gs^Ft, Gs^Ft, Wwt, Chw, Chw, Chw, Wwt, Wot, Wwt, Wwt, Hh^Ft, Hh^Ft, Gs^Ft, Wwt, Wwt, Wot, Wot, Wot, Wot, Wot, Wot, Wot, Wot, Wot, Wot, Wot
Wot, Wot, Wot, Wot, Wot, Wot, Wwt, Chw, Wwt, Wwt, Wwrt, Dd, Hh, Rrc, Rrc, Gs^Ft, Wwt, Wwt, Chw, 2 Khw, Chw, Wwt, Wwt, Wwt, Dd, Dd^Es, Csz, Gs^Ft, Wwt, Wwt, Wot, Chw, Wot, Wot, Wot, Wot, Wwt, Wwt^Vm, Wot, Wot, Wot
Wot, Wot, Wot, Wot, Wot, Wot, Wwt, Wwt, Wwrt, Wwt, Wwrt, Dd^Ft, Hh^Ft, Rrc, Rrc, Hh^Ft, Gs^Ft, Wwt, Wwt, Chw, Wwt, Wwt, Wwt, Dd, Dd^Ft, Csz, 1 Csz^Ksy, Chw, Wwt, Wot, Wot, Wot, Wot, Wot, Wot, Wot, Wwt, Wwt, Wwt, Wot, Wot
Wot, Wot, Wot, Wot, Wot, Wwt, Wwrt, Wwrt, Wwrt, Wwrt, Dd, Dd, Dd, Rrc, Hh^Ft, Hh^Ft, Wwrt, Wwt, Wot, Wwt, Dd, Dd^Ft, Hd^Ft, Wo, Dd, Csz, Ww^Vm, Chw, Wot, Wot, Wot, Wot, Wot, Wot, Wot, Wot, Wot, Wot, Wot, Wot, Wot
Wot, Wot, Wot, Wot, Wot, Wwt, Wwrt, Chw, Wwrt, Wwrt, Wwrt, Dd, Wwrt, Dd^Ft, Wwrt, Wwrt, Wwt, Wwt, Wot, Wwt, Dd^Es, Hd^Vhs, Dd, Wwt, Wwt, Dd^Es, Wwt, Wwt, Wot, Wot, Wot, Chw, Wot, Wot, Wot, Wot, Wot, Wot, Wot, Wot, Wot
Wot, Wot, Wot, Wot^Vm, Wot, Wwt, Wwrt, Wwrt, Wwrt, Wwrt, Chw, Wwrt, Wwrt, Dd^Ft, Wwrt, Wwrt, Wwt, Wot, Wot, Wwt, Wwt, Dd^Es, Wwt, Wwt, Wot, Wwt, Wot, Wot, Chw, Wot, Wot, Wot, Wot, Wot, Wot, Wot, Wot, Wot, Wot, Wot, Wot
Wot, Wot, Wot, Wot, Wwt, Wwt, Wwrt, Wwrt, Wwt, Wwrt, Wwrt, Wwrt, Wwrt, Wwrt, Wwrt, Wwt, Wwt, Wwt, Wwt, Wot, Wot, Wwt, Wot, Wot, Wot, Wot, Wot, Wot, Wot, Wot, Wot, Wot, Wot, Wot, Wot, Wot, Wot, Wot, Wot, Wot, Wot
Wot, Wot, Wot, Wot, Wwt, Wwrt, Wwt, Wwrt, Wwrt, Wwrt, Wwrt, Wwt, Wwrt, Chw, Wwrt, Wwt, Wwt, Chw, Wwt, Wot, Wot, Chw, Wot, Wot, Wot, Chw, Wot, Wot, Wot, Wot, Wot, Wot, Wot, Wot, Wot, Wot, Wot, Wot, Wot, Wot, Wot
Wot, Wot, Wot, Wwt, Dd^Ft, Wwt, Dd^Ft, Wwt, Wwrt, Wwrt, Wwt, Wwrt, Wwt, Wwrt, Wwt, Wwt, Wot, Wwt, Wot, Wot, Wot, Wot, Wot, Wot, Wot, Wot, Wot, Wot, Wot, Wot, Wot, Wot, Wot, Wot, Wot, Wot, Wot, Wot, Wot, Wot, Wot
Wot, Wot, Wwt, Wwt, Dd^Ft, Dd^Ft, Dd^Ft, Wwt, Wwt, Wwrt, Wwrt, Wwt, Wot, Wwt, Wot, Wot, Wot, Wot, Wot, Wot, Wot, Wot, Wot, Wot, Wot, Wot, Wot, Wot, Wot, Wot, Wot, Wot, Wwt, Wot, Wwt, Wwt, Wwt, Wot, Wot, Wot, Wot
Wot, Wot, Wwt, Dd^Ft, Hh^Ft, Hd^Vht, Hd^Es, Ds, Wwt, Wwrt, Wwt, Wwt, Wot, Wot, Wot, Wot, Wot, Wot, Wot, Wot, Wot, Wot, Wot, Wot, Wot, Wot, Wot, Wot, Wot, Wot, Wot, Wwt, Dd, Wwt, Gs^Ft, Gs^Ft, Wwt, Wot, Wot, Wot, Wot
Wot, Wot, Wwt, Dd, Gs^Ft, Hh^Ft, Dd^Ft, Ds, Ds, Wwt, Wwt, Wot, Wot, Wot, Wot, Wot, Wwt, Wwt, Wwt^Vm, Wwt, Wot, Wot, Wot, Wot, Wot, Wot, Wot, Wot, Wwt, Wwt, Wwrt, Wwrt, Dd, Gs^Ft, Hh^Ft, Gs^Ft, Dd, Wwt, Wot, Wot, Wot
Wot, Wot, Wwt, Dd, Dd^Ft, Gs^Ft, 4 Gs^Ft, Dd^Es, Ds^Es, Wwt, Wwt, Wot, Wot, Wot, Wot, Wot, Wot, Wwt, Wwt, Wot, Wot, Wot, Wot, Wot, Wot, Wot, Wwt, Wwt, Dd, Dd, Dd^Es, Wwrt, Dd^Es, Dd^Vht, Hh^Ft, Dd^Vht, Dd, Wwt, Wot, Wot, Wot
Wot, Wot, Wot, Wwt, Dd, Gs^Ft, Gs^Ft, Dd^Es, Dd, Dd^Ft, Wwt, Wwt, Wot, Wot, Wot, Wot, Wot, Wwt, Wot, Wwt, Wot, Wot, Wot, Wot, Wot, Wot, Wwt, Dd, Dd^Ft, Dd^Vdt, Dd^Es, Dd, Dd^Es, Dd^Es, Dd^Ft, Dd^Ft, Wwt, Wwt, Wot, Wot, Wot
Wot, Wot, Wot, Wwt, Dd^Ft, Dd, Dd^Ft, Dd, Wwt, Wwt^Bw\, Wwt, Wot, Wot, Wot, Wot, Wot, Wot, Wot, Wot, Wot, Wot, Wot, Wot, Wot, Wot, Wwrt, Wwrt, Wwt, Wwt, Dd^Ft, Wwt, Wwt, Wwt, Wwt, Wwt, Dd^Ft, Wwt, Wot, Wot, Wot, Wot
Wot, Wot, Wot, Wwt, Wwt, Wwt, Wwt, Wwt, Wot, Wwt, Wot, Wot, Wot, Wot, Wot, Wot, Wot, Wot, Wot, Wot, Wot, Wot, Wot, Wot, Wot, Wot, Wot, Wot, Wot, Wwt, Wwt, Wot, Wot, Wot, Wot, Wwt, Wot, Wot, Wot, Wot, Wot
Wot, Wot, Wot, Wot, Wot, Wot, Wot, Wot, Wot, Wot, Wot, Wot, Wot, Wot, Wot, Wot, Wot, Wot, Wot, Wot, Wot, Wot, Wot, Wot, Wot, Wot, Wot, Wot, Wot, Wot, Wot, Wot, Wot, Wot, Wot, Wot, Wot, Wot, Wot, Wot, Wot
Wot, Wot, Wot, Wot, Wot, Wot, Wot, Wot, Wot, Wot, Wot, Wot, Wot, Wot, Wot, Wot, Wot, Wot, Wot, Wot, Wot, Wot, Wot, Wot, Wot, Wot, Wot, Wot, Wot, Wot, Wot, Wot, Wot, Wot, Wot, Wot, Wot, Wot, Wot, Wot, Wot
