border_size=1
usage=map

Wot, Wot, Wot, Wot, Wot, Wwt, Wwt, Wwt, Wwt, Dd^Ftd, Dd^Ftd, Dd^Ftd, Ss, Dd^Ftd, Dd^Ftd, Hd^Ftd, Hd^Ftd, Dd^Ftd, Dd^Ftd, Dd, Rd, Rd, Dd^Es, Dd^Ftd, Hd^Ftd, Dd^Ftd, Ss, Ss, Ss, Ss, Ss, Ss, Ss, Gg, Gs, Ss, Ss, Ss, Ss, Ss, Ss, Ss
Wot, Wot, Wot, Wot, Wot, Wot, Wot, Wwt, Wwt, Wwt, Wwt, Dd^Ftd, Ss, Ss, Dd^Ftd, Dd^Ftd, Dd^Ftd, Dd^Ftd, Dd^Es, Dd^Es, Rd, Dd, Dd^Es, Dd^Ftd, Dd^Ftd, Dd^Ftd, Ss, Ss, Dd^Ftd, Dd^Ftd, Ss, Ss, Gg, Gs, Gs, Gs, Gs, Ss, Gg, Ss, Ss, Ss
Wot, Wot, 1 Wot, Wot, Wot, Wot, Wot, Wot, Wot, Wwt, Wwt, Wwt, Wwt, Wwt, Wwt, Dd^Ftd, Dd, Dd^Es, Rd, Rd, Dd, Dd, Dd^Vdt, Dd^Es, Dd^Ftd, Dd^Ftd, Ss, Dd^Ftd, Dd^Ftd, Dd^Ftd, Ss, Ss, Gs, Ss, Ss, Gs, Ss, Gs, Gs, Gg, Ss^Vhs, Gd
Wwt, Wot, Wot, Wot, Wot, Wot, Wot, Wot, Wot, Wot, Wot, Wwt, Wot, Wwt, Wwt, Wwt, Wwt, Dd, Dd, Dd, Dd, Dd, Dd, Dd, Ss, Ss, Ss, Dd^Ftd, Dd^Ftd, Dd^Ftd, Dd^Ftd, Ss, Ss, Gs, Gs, Ss, Ss, Gs, Gg, Gg, Gd, Gd
Wwt, Wwt, Wwt, Wot, Wwt, Wot, Wot, Wot, Wot, Wot, Wot, Wot, Wot, Wwt, Wwt^Bw/, Wwt^Bw/, Wwt, Wwt, Wwt, Wwt, Wwt, Wwt, Wwt, Wwt, Wwt, Wwt, Wwt, Wwt, Wwt, Dd^Ftd, Ss, Ss, Ss, Gs, Gs, Chs, 2 Ke, Ss, Gs, Gs, Gd, Gs
Wwt, Wwt, Wwt, Wwt, Wwt, Wwt, Wwt, Wot, Wot, Wot, Wot, Wot, Wot, Wot, Wot, Wot, Wot, Wwt, Wwt, Wwt, Wwt, Wwt, Wwt, Wwt, Wot, Wot, Wot, Wwt, Wwt, Wwt, Wwt, Ss, Ss^Vhs, Ss, Gs, Ce, Ce, Ce, Gd, Gd, Gs, Gs
Dd, Wwt, Dd, Wwt, Wwt, Wwt, Wwt, Wwt, Wwt, Wot, Wot^Bw/, Wot, Wot, Wot, Wot, Wot, Wot, Wot, Wot, Wot, Wot, Wot, Wot, Wot, Wot, Wot, Wot, Wwt, Wot, Wwt, Wwt, Ss, Wwt, Ss, Gs, Gs, Gs, Gs, Gd, Gs, Ce, Gs
Dd, Dd, Dd^Vdt, Dd, Dd, Dd, Dd, Wwt, Wwt, Wwt, Wwt, Wwt, Wwt, Wot, Wot, Wot, Wot, Wot, Wot, Wot, Wot, Wot, Wot, Wot, Wot, Wot, Wot, Wot, Wot, Wwt, Wwt, Wwt, Wwt, Ss, Wwt, Gs, Gs, Gd, Gs, Gs, Gs, Gs
Dd^Ftd, Dd, Dd^Es, Dd^Es, Dd, Ss, Ss, Dd, Ss, Wwt, Ss, Wwt, Wwt, Wwt, Wwt, Wwt, Wwt, Wot, Wwt, Wot, Wot, Wot, Wot, Wot, Wot, Wot, Wot, Wot, Wot, Wot, Wot, Wot, Wot, Wwt, Wwt, Wwt, Wwt^Bsb/, Gd, Ss, Gs, Ss, Gs
Dd^Ftd, Dd^Ftd, Ss, Dd^Ftd, Ss, Ss, Dd^Ftd, Ss, Dd^Ftd, Dd^Ftd, Dd^Ftd, Dd^Ftd, Wwt, Wwt, Ss, Wwt, Wwt, Wwt, Wwt, Wwt, Wot, Wot, Wwt, Wwt, Wwt, Wwt, Wwt, Wwt, Wot, Wot, Wot, Wot, Wot, Wot, Wwt^Bsb/, Wwt^Bsb/, Wwt, Wwt, Wwt, Ss, Wwt, Ss
Ss, Ss, Ss, Ss, Dd^Ftd, Dd^Ftd, Hd^Ftd, Dd^Ftd, Dd^Ftd, Dd^Ftd, Ss, Ss, Wwt, Dd, Dd^Noe, Dd, Ss, Wwt, Wwt, Wwt, Wot, Wwt, Wwt, Wwt, Wwt, Wwt, Wwt, Wwt, Wwt, Wwt, Wwt, Wot, Wot^Bsb/, Wot^Bsb/, Wot, Wwt, Wot, Wwt, Wwt, Wwt, Wwt, Wwt
Dd^Ftd, Ss, Dd^Ftd, Ss, Dd^Ftd, Hd^Ftd, Dd^Ftd, Dd^Ftd, Ss, Dd^Ftd, Dd^Ftd, Ss, Wwt, Dd, Dd, Dd, Rd, Ss^Vhs, Wwt, Wwt, Wwt, Wwt, Dd^Ftd, Wwf, Dd, Wwf, Wwf, Wwt, Wwt, Wwt, Wwt^Bsb/, Wot^Bsb/, Wwt, Wot, Wot, Wot, Wot, Wot, Wot, Wwt, Wot, Wwt
Dd^Ftd, Dd^Ftd, Dd^Ftd, Dd^Ftd, Hd^Ftd, Hd^Ftd, Dd^Ftd, Ss, Dd^Ftd, Ss, Ss, Ss, Dd^Ftd, Wwt, Wwt, Ss, Rd, Ss, Ss, Wwt, Wwt, Wwt, Dd^Ftd, Dd, Dd^Vdt, Dd, Dd, Dd, Rd, Wwt^Bsb/, Wwt, Wwt, Wwt, Wot, Wwt, Wot, Wot, Wot, Wot, Wot, Wot, Wwt
Dd, Dd^Ftd, Dd, Dd^Ftd, Dd^Ftd, Dd^Ftd, Dd^Ftd, Dd^Ftd, Hd^Ftd, Dd^Ftd, Ss, Dd^Ftd, Dd^Ftd, Dd^Ftd, Wwt, Dd^Ftd, Dd^Ftd, Rd, Ss, Ss, Dd^Ftd, Dd^Ftd, Dd, Dd^Es, Dd^Es, Dd, Hd^Ftd, Rd, Hd^Ftd, Dd^Ftd, Dd^Ftd, Wwt, Wwt, Wwt, Wwt, Wot, Wwt, Wot, Wot, Wot, Wot, Wot
Dd, Dd, Dd^Dc, Dd, Dd, Dd, Dd, Dd^Ftd, Dd^Ftd, Dd^Ftd, Ss, Ss, Ss, Wwt, Dd^Ftd, Dd^Ftd, Dd^Ftd, Rd, Wwt^Bw\r, Dd^Ftd, Rd, Dd, Rd, Dd^Es, Rd, Hd^Ftd, Hd^Ftd, Rd, Rd, Hd^Ftd, Hd^Ftd, Dd, Dd, Wwt, Wwt, Wwt, Wwt, Wwt, Wwt, Wot, Wot, Wot
Dd, Dd, Dd, Dd^Es, Dd, Dd^Vdt, Dd^Ftd, Dd^Ftd, Dd^Ftd, Ss, Ss, Dd^Ftd, Dd^Ftd, Wwt, Wwt, Wwt, Wwt, Ss, Dd^Ftd, Rd, Dd, Rd, Dd, Rd, Dd, Rd, Rd, Rd, Hd^Ftd, Rd, Rd, Dd, Dd^Vdt, Dd, Dd^Ftd, Wwt, Wwt, Wwt, Wwt, Wwt, Wwt, Wot
Dd^Ftd, Dd, Dd^Ftd, Dd^Es, Dd^Ftd, Dd^Ftd, Dd^Ftd, Ss, Ss, Ss, Ss, Dd^Ftd, Dd^Ftd, Dd^Ftd, Dd^Ftd, Dd^Ftd, Dd^Ftd, Wwt, Wwt, Dd^Ftd, Hd^Ftd, Dd, Hd^Ftd, Dd, Hd^Ftd, Dd, Dd, Hd^Ftd, Dd^Ftd, Hd^Ftd, Rd, Dd, Dd, Dd, Dd, Dd^Ftd, Dd^Es, Dd, Dd^Ftd, Wwt, Wwt, Wwt
Dd^Ftd, Dd^Ftd, Dd^Ftd, Dd^Ftd, Dd^Ftd, Dd^Ftd, Gs^Fms, Gll^Fp, Gll^Fp, Gll^Fp, Gll^Fp, Ss, Dd^Ftd, Dd^Vdt, Dd^Es, Dd, Dd, Dd^Ftd, Wwt, Dd^Ftd, Dd^Ftd, Hd^Ftd, Dd^Ftd, Hd^Ftd, Dd^Ftd, Dd, Dd^Es, Dd, Dd^Ftd, Dd, Dd, Rd, Rd, Rd, Rd, Dd, Dd^Es, Dd^Vdt, Dd, Dd^Ftd, Wwt, Wwt
Dd^Ftd, Dd^Ftd, Gs^Fms, Dd^Ftd, Gs^Fms, Gs^Fms, Hh^Fds, Hh^Fds, Hh^Fds, Gs^Fms, Hh^Fds, Dd^Ftd, Dd^Ftd, Dd^Es, Dd^Es, Dd^Dr, Dd^Ftd, Dd^Ftd, Dd^Ftd, Wwt, Dd^Ftd, Hd^Ftd, Dd^Es, Dd^Ftd, Dd, Dd, Dd^Dr, Dd, Dd, Dd^Ftd, Dd^Ftd, Dd, Dd, Dd, Dd, Rd, Rd, Dd, Rd, Dd, Dd, Dd^Ftd
Gs^Fms, Gs^Fms, Hh^Fds, Hh^Fds, Hh^Fds, Hh^Fds, Mm, Hh^Fds, Hh^Fds, Hh^Fds, Hh^Fds, Hh^Fds, Hh^Fds, Dd^Ftd, Dd^Ftd, Dd^Ftd, Ss, Dd^Ftd, Wwt, Wwt, Ss, Dd^Ftd, Dd, Dd^Es, Ce, Dd, Dd, Dd, Dd^Vdt, Dd, Hd^Ftd, Dd^Ftd, Dd^Ftd, Dd^Es, Dd^Es, Dd, Dd, Rd, Dd, Rd, Rd, Dd
Hh^Fds, Hh^Fds, Hh^Fds, Hh^Fds, Hh^Fds, Hh^Fds, Mm, Mm, Hh^Fds, Mm, Mm, Mm, Mm, Hh^Fds, Hh^Fds, Dd^Ftd, Ss, Wwt, Ss, Ss, Ss, Dd^Ftd, Dd, Ce, 4 Ke, Ce, Dd^Es, Dd^Es, Dd^Es, Dd^Es, Dd^Ftd, Dd^Ftd, Dd^Ftd, Hd^Ftd, Dd^Ftd, Dd^Es, Dd^Es, Dd, Dd^Es, Dd, Dd, Rd
Hh^Fds, Hh^Fds, Hh^Fds, Hh^Fds, Mm, Mm, Mm, Mm, Mm, Mm, Mm, Mm, Mm, Mm, Hh^Fds, Ss, Wwt, Wwt, Hh^Fds, Gs^Fms, Gs^Fms, Ss, Ss, Ce, Ce, Ce, Hh^Fds, Dd^Ftd, Ss, Ss, Ss, Ss, Ss, Dd^Ftd, Gs^Fms, Dd^Ftd, Dd^Ftd, Dd^Ftd, Dd^Ftd, Dd^Es, Dd^Vdt, Dd
Hh^Fds, Hh^Fds, Hh^Fds, Hhd^Vhhr, Mm, Mm, Mm, Mm, Mm, Mm, Hh^Fds, Mm, Hh^Fds, Hh^Fds, Hh^Fds, Hh^Fds, Ww, Hh^Fds, Mm, Hh^Fds, Hh^Fds, Gs^Fms, Gs^Fms, Gs^Fms, Gs^Fms, Hh^Fds, Mm, Gs^Fms, Gs^Fms, Ss, Ss, Ss, Ss, Ss, Gs^Fms, Gs^Fms, Gs^Fms, Gs^Fms, Gs^Fms, Dd^Ftd, Dd^Es, Dd^Es
Hh^Fds, Hh^Fds, Hh^Fds, Mm, Mm, Mm, Mm, Mm, Mm, Mm, Mm, Hh^Fds, Hh^Fds, Hh^Fds, Ww, Ww, Hhd^Vhhr, Mm, Mm, Hh^Fds, Mm, Hh^Fds, Hh^Fds, Gs^Fms, Mm, Mm, Mm, Hh^Fds, Hh^Fds, Gs^Fms, Gs^Fms, Gs^Fms, Gs^Fms, Gs^Fms, Hh^Fds, Hh^Fds, Mm, Hh^Fds, Hh^Fds, Gs^Fms, Hh^Fds, Hd
Mm, Mm, Mm, Hh^Fds, Mm, Hh^Fds, Hh^Fds, Mm, Hh^Fds, Mm, Hh^Fds, Mm, Hh^Fds, Hh^Fds, Ww, Hh^Fds, Hh^Fds, Hh^Fds, Hh^Fds, Mm, Hh^Fds, Hh^Fds, Hh^Fds, Hh^Fds, Hh^Fds, Mm, Mm, Hh^Fds, Mm, Hh^Fds, Hh^Fds, Hh^Fds, Hhd^Vhhr, Hh^Fds, Mm, Hh^Fds, Mm, Mm, Mm, Hh^Fds, Hh^Fds, Hh^Fds
Mm, Mm, Mm, Mm, Mm, Mm, Mm, Mm, Mm, Hh^Fds, Mm, Mm, Mm, Ww, Mm, Hh^Fds, Mm, Hh^Fds, Hh^Fds, Hh^Fds, Mm, Hh^Fds, Hh^Fds, Hh^Fds, Mm, Mm, Mm, Mm, Mm, Mm, Hh^Fds, Hh^Fds, Hh^Fds, Mm, Hh^Fds, Mm, Hh^Fds, Mm, Hh^Fds, Mm, Mm, Hh^Fds
