border_size=1
usage=map

Wo, Wot, Wot, Wo, Wo, Ww, Ww, Ww, Ww, Dd^Ftd, Dd^Ftd, Dd^Ftd, Ss, Dd^Ftd, Dd^Ftd, Hd^Ftd, Hd^Ftd, Dd^Ftd, Dd^Ftd, Dd, Rd, Rd, Dd^Es, Dd^Ftd, Hd^Ftd, Dd^Ftd, Ss, Ss, Ss, Ww, Ww, Ss, Ss, Gg, Gs, Ss, Ss, Ss, Ss, Ss, Ss, Ss
Wo, Wot, Wot, Wot, Wot, Wo, Wo, Ww, Ww, Ww, Ww, Dd^Ftd, Ss, Ss, Dd^Ftd, Dd^Ftd, Dd^Ftd, Dd^Ftd, Dd^Es, Dd^Es, Rd, Dd, Dd^Es, Dd^Ftd, Dd^Ftd, Dd^Ftd, Ss, Ss, Ww, Ww, Ww, Ss, Gg, Gs, Gs, Gs, Gs, Ss, Gg, Ss, Ss, Ss
Wo, Wo, 1 Wot, Wot, Wot, Wot, Wot, Wo, Wo, Ww, Ww, Ww, Ww, Ww, Ww, Dd^Ftd, Dd, Dd^Es, Rd, Rd, Dd, Dd, Dd^Vdt, Dd^Es, Dd^Ftd, Dd^Ftd, Ss, Ss, Ww, Ww, Ss, Ss, Gs, Ss, Ss, Gs, Ss, Gs, Gs, Gg, Ss^Vhs, Gd
Ww, Wo, Wo, Wot, Wo, Wot, Wot, Wot, Wot, Wo, Wo, Ww, Wo, Ww, Ww, Ww, Ww^Bw/r, Dd, Dd, Dd, Dd, Dd, Dd, Dd, Ss, Ss, Ss, Ww, Ww, Ww, Ww, Ss, Ss, Gs, Gs, Ss, Ss, Gs, Gg, Gg, Gd, Gd
Ww, Ww, Ww, Wo, Ww, Wo, Wo, Wot, Wot, Wot, Wot, Wo, Wo, Ww, Ww, Ww, Ww, Ww, Ww, Ww, Ww, Ww, Ww, Ww, Ww, Ww, Ww, Ww, Wo, Ww, Ss, Ss, Ss, Gs, Gs, Chs, 2 Ke, Ss, Gs, Gs, Gd, Gs
Ww, Ww, Ww, Ww, Ww, Ww, Ww, Wo, Wo, Wot, Wot, Wot, Wot^Bw/r, Wo^Bw/r, Wo, Wo, Wo, Ww, Ww, Ww, Ww, Ww, Ww, Ww, Wo, Wo, Wo, Wo, Wo, Ww, Ww, Ss, Ss^Vhs, Ss, Gs, Ce, Ce, Ce, Gd, Gd, Gs, Gs
Dd, Ww, Dd, Ww, Ww, Ww, Ww, Ww, Ww, Wo, Wo^Bw/r, Wo^Bw/r, Wo, Wot, Wot, Wot, Wot, Wo, Wot, Wo, Wo, Wo, Wo, Wo, Wot, Wot, Wot, Wot, Wot, Wo, Ww, Ss, Ww, Ss, Gs, Gs, Gs, Gs, Gd, Gs, Ce, Gs
Dd^Ftd, Dd, Dd^Vdt, Dd, Dd, Dd, Dd, Ww, Ww^Bw/r, Ww, Ww, Ww, Ww, Wo, Wo, Wo, Wo, Wot, Wo, Wot, Wot, Wot, Wot, Wot, Wot, Wot, Wot, Wot, Wot, Wo, Wo, Ww, Ww, Ss, Ww, Gs, Gs, Gd, Gs, Gs, Gs, Gs
Rd, Dd^Ftd, Rd, Dd^Es, Rd, Rd, Rd, Rd, Ss, Ww, Ss, Ww, Ww, Ww, Ww, Ww, Ww, Wo, Ww, Wo, Wo, Wot, Wo, Wo, Wo, Wo, Wo, Wot, Wot, Wot, Wot, Wo, Wo, Ww, Ww, Ww, Ww^Bsb/, Gd, Ss, Gs, Ss, Gs
Dd^Ftd, Rd, Ss, Rd, Ss, Ss, Dd^Ftd, Ss, Dd^Ftd, Dd^Ftd, Dd^Ftd, Dd^Ftd, Wwt, Ww, Ss, Ww, Ww, Ww, Ww, Wo, Wo, Wo, Ww, Ww, Ww, Ww, Ww, Wo, Wo, Wot, Wot, Wot, Wot, Wo, Wo^Bsb/, Ww^Bsb/, Ww, Ww, Ww, Ss, Ww, Ss
Ss, Ss, Ss, Ss, Dd^Ftd, Dd^Ftd, Hd^Ftd, Dd^Ftd, Dd, Dd^Ftd, Ss, Ss, Wwt, Dd, Dd^Noe, Dd, Ss, Ww, Ww, Ww, Wo, Ww, Ww, Ww, Ww, Ww, Ww, Ww, Wo, Wo, Wo, Wot, Wot^Bsb/, Wot^Bsb/, Wot, Wo, Ww, Ww, Ww, Ww, Ww, Ww
Gs^Ft, Ss, Gs^Ft, Ss, Ss, Dd, Dd, Dd, Ss, Dd^Ftd, Dd^Ftd, Ss, Wwt, Dd, Dd, Dd, Rd, Ss^Vhs, Ww, Ww, Ww, Ww, Dd^Ftd, Wwf, Dd, Wwf, Wwf, Ww, Ww, Ww, Ww^Bsb/, Wo^Bsb/, Wo, Wot, Wot, Wo, Wo, Wo, Wo, Ww, Ww, Ww
Hh^Ftp, Gs^Ft, Hh^Ftp, Gs^Ft, Ss, Dd^Es, Dd^Ftd, Ss, Dd, Ss, Ss, Ss, Dd^Ftd, Wwt, Wwt, Ss, Rd, Ss, Ss, Ww, Ww, Ww, Dd^Ftd, Dd, Dd^Vdt, Dd, Dd, Dd, Rd, Ww^Bsb/, Ww, Ww, Ww, Wo, Wo, Wot, Wot, Wot, Wot, Wo, Wo, Ww
Dd^Ftd, Hh^Ftp, Gs^Ft, Ss, Ss, Dd^Ftd, Hd^Ftd, Dd^Ftd, Hd^Ftd, Sm, Sm, Dd^Ftd, Dd^Ftd, Dd^Ftd, Wwt, Dd^Ftd, Dd^Ftd, Rd, Ss, Ss, Dd^Ftd, Dd^Ftd, Dd, Hd, Dd^Es, Dd, Hd^Ftd, Rd, Hd^Ftd, Dd^Ftd, Dd^Ftd, Ww, Ww, Ww, Ww, Wo, Wo, Wo, Wo, Wot, Wot, Wo
Dd^Ftd, Dd^Ftd, Gs^Ft, Ss, Dd, Dd, Dd, Hd^Ftd, Gs^Ftp, Gs^Ftp, Ss, Ss, Ss, Wwt, Dd^Ftd, Dd^Ftd, Dd^Ftd, Rd, Ss^Bw\, Dd^Ftd, Rd, Dd, Rd, Dd^Es, Rd, Hd^Ftd, Hd^Ftd, Rd, Rd, Hd^Ftd, Hd^Ftd, Dd^Ftd, Dd, Ww, Ww, Ww, Ww, Ww, Ww, Wo, Wo, Wot
Hh^Ftp, Hh^Ftp, Ss, Ss, Dd, Dd^Vdt, Dd^Ftd, Gs^Ftp, Gs^Ftp, Ss, Ss, Gs^Ftp, Dd^Ftd, Wwt, Wwt, Wwt, Wwt, Ss, Dd^Ftd, Rd, Dd, Rd, Dd, Rd, Dd, Rd, Rd, Rd, Hd^Ftd, Rd, Rd, Dd, Dd^Vdt, Dd, Dd^Ftd, Ww, Ww, Ww, Ww, Ww, Ww, Wo
Ss, Gs^Ft, Ss, Dd^Es, Gs^Ftp, Gs^Ftp, Gs^Ftp, Ss, Ss, Ss, Ss, Gs^Ftp, Dd^Ftd, Dd^Ftd, Dd^Ftd, Dd^Ftd, Dd^Ftd, Wwt, Wwt, Dd^Ftd, Hd^Ftd, Dd, Hd^Ftd, Dd, Hd^Ftd, Dd, Dd, Hd^Ftd, Dd^Ftd, Hd^Ftd, Rd, Dd, Dd, Dd, Dd, Dd^Ftd, Dd^Es, Dd, Dd^Ftd, Ww, Ww, Ww
Ss, Ss, Ww, Ss, Ww, Gs^Ftp, Hh^Fds, Gs^Fds, Gs^Fds, Gs^Fds, Gs^Fds, Ss, Dd^Ftd, Dd^Vdt, Dd^Es, Dd, Dd, Dd^Ftd, Wwt, Dd^Ftd, Dd^Ftd, Hd^Ftd, Dd^Ftd, Hd^Ftd, Dd^Ftd, Dd, Dd^Es, Dd, Dd^Ftd, Dd, Dd, Rd, Rd, Rd, Rd, Dd, Dd^Es, Dd^Vdt, Dd, Dd^Ftd, Ww, Ww
Gs^Ftp, Gs^Ftp, Gs^Fms, Ww, Gs^Fms, Gs^Fms, Hh^Fds, Hh^Fds, Hh^Fds, Gs^Fms, Hh^Fds, Gs^Ftp, Gs^Ftp, Dd^Es, Dd^Es, Dd^Dr, Dd^Ftd, Dd^Ftd, Dd^Ftd, Wwt, Dd^Ftd, Hd^Ftd, Dd^Es, Dd^Ftd, Dd, Dd, Dd^Dr, Dd, Dd, Dd^Ftd, Dd^Ftd, Dd, Dd, Dd, Dd, Rd, Rd, Dd, Rd, Dd, Dd, Dd^Ftd
Gs^Fms, Gs^Fms, Ww, Ww, Hh^Fds, Hh^Fds, Mm, Hh^Fds, Hh^Fds, Hh^Fds, Hh^Fds, Hh^Fds, Hh^Fds, Gs^Ftp, Gs^Ftp, Dd^Ftd, Ss, Dd^Ftd, Wwt, Wwt, Ss, Dd^Ftd, Dd, Dd^Es, Ce, Dd, Dd, Dd, Dd^Vdt, Dd, Hd^Ftd, Dd^Ftd, Dd^Ftd, Dd^Es, Dd^Es, Dd, Dd, Rd, Dd, Rd, Rd, Dd
Hh^Fds, Hh^Fds, Ww, Hh^Fds, Hh^Fds, Hh^Fds, Mm, Mm, Hh^Fds, Mm, Mm, Mm, Mm, Hh^Fds, Hh^Fds, Gs^Ftp, Ss, Wwt, Ss, Ss, Ss, Dd^Ftd, Dd, Ce, 4 Ke, Ce, Dd^Es, Dd^Es, Dd^Es, Dd^Es, Dd^Ftd, Dd^Ftd, Dd^Ftd, Hd^Ftd, Dd^Ftd, Dd^Es, Dd^Es, Dd, Dd^Es, Dd, Dd, Rd
Hh^Fds, Ww, Hh^Fds, Hh^Fds, Mm, Mm, Mm, Mm, Mm, Mm, Mm, Mm, Mm, Mm, Hh^Fds, Ss, Wwt, Wwt, Hh^Fds, Sm, Sm, Ss, Ss, Ce, Ce, Ce, Hh^Fds, Dd^Ftd, Ss, Ss, Ss, Ss, Ss, Dd^Ftd, Gs^Fms, Dd^Ftd, Dd^Ftd, Dd^Ftd, Dd^Ftd, Dd^Es, Dd^Vdt, Dd
Ww, Ww, Hh^Fds, Hhd^Vhhr, Mm, Mm, Mm, Mm, Mm, Mm, Hh^Fds, Mm, Hh^Fds, Hh^Fds, Hh^Fds, Hh^Fds, Ww, Hh^Fds, Mm, Hh^Fds, Hh^Fds, Gs^Fms, Gs^Fms, Gs^Fms, Gs^Fms, Hh^Fds, Mm, Gs^Fms, Gs^Fms, Sm, Sm, Sm, Ss, Ss, Gs^Fms, Gs^Fms, Gs^Fms, Gs^Fms, Gs^Fms, Dd^Ftd, Dd^Es, Dd^Es
Hh^Fds, Hh^Fds, Hh^Fds, Mm, Mm, Mm, Mm, Mm, Mm, Mm, Mm, Hh^Fds, Hh^Fds, Hh^Fds, Ww, Ww, Hhd^Vhhr, Mm, Mm, Hh^Fds, Mm, Hh^Fds, Hh^Fds, Gs^Fms, Mm, Mm, Mm, Hh^Fds, Hh^Fds, Sm, Gs^Fms, Gs^Fms, Gs^Fms, Gs^Fms, Hh^Fds, Hh^Fds, Mm, Hh^Fds, Hh^Fds, Gs^Fms, Hh^Fds, Hd
Mm, Mm, Mm, Hh^Fds, Mm, Hh^Fds, Hh^Fds, Mm, Hh^Fds, Mm, Hh^Fds, Mm, Hh^Fds, Hh^Fds, Ww, Hh^Fds, Hh^Fds, Hh^Fds, Hh^Fds, Mm, Hh^Fds, Hh^Fds, Hh^Fds, Hh^Fds, Hh^Fds, Mm, Mm, Hh^Fds, Mm, Hh^Fds, Hh^Fds, Hh^Fds, Hhd^Vhhr, Hh^Fds, Mm, Hh^Fds, Mm, Mm, Mm, Hh^Fds, Hh^Fds, Hh^Fds
Mm, Mm, Mm, Mm, Mm, Mm, Mm, Mm, Mm, Hh^Fds, Mm, Mm, Mm, Ww, Mm, Hh^Fds, Mm, Hh^Fds, Hh^Fds, Hh^Fds, Mm, Hh^Fds, Hh^Fds, Hh^Fds, Mm, Mm, Mm, Mm, Mm, Mm, Hh^Fds, Hh^Fds, Hh^Fds, Mm, Hh^Fds, Mm, Hh^Fds, Mm, Hh^Fds, Mm, Mm, Hh^Fds
