border_size=1
usage=map

Ha, Aa, Aa, Dd, Dd, Dd, Dd, Dd, Dd, Ds, Dd, Dd, Dd, Dd, Ha, Ha, Dd^Es, Dd, Hd, Hd, Hd, Hd, Dd^Es, Ha, Ha, Ms, Ha, Ha, Ha, Ha, Ha, Dd, Dd^Es, Hd, Hd, Dd
Ha, Ha, Aa, Aa, Dd, Dd, Dd, Dd, Dd, Aa, Aa, Aa, Aa, Dd, Dd, Ha, Dd, Dd^Es, Dd, Dd, Dd, Dd^Es, Dd^Es, Dd^Es, Dd^Es, Ha, Dd, Dd^Es, Dd, Dd^Es, Dd, Dd^Es, Dd, Dd, Dd, Dd
Ha, Ha, Ha, Aa, Dd, Dd, Dd, Aa, Aa, Aa, Ha, Ha, Ha, Aa, Aa, Dd, Dd, Aa^Vaa, Aa, Aa, Aa, Aa, Aa, Dd, Aa, Dd, Aa, Dd^Es, Aa, Dd^Es, Ha, Ha, Dd^Es, Aa, Aa, Aa
Md, Ms, Ha, Aa, Dd, Dd, Aa, Aa, Ha, Ha, Aa, Aa, Aa, Aa, Aa, Aa, Dd^Es, Dd, Aa, Aa, Dd^Es, Aa, Dd, Aa, Aa, Aa, Aa, Aa, Aa, Dd, Dd^Es, Dd^Es, Dd, Aa, Aa, Aa
Md, Ha, Ha^Fpa, Aa, Aa, Dd, Aa, Aa, Aa, Aa, Dd, Dd, Dd, Dd, Dd, Dd, Dd^Es, Dd^Es, Dd, Aa, Dd^Es, Dd, Ha, Dd, Aa, Aa, Dd, Aa^Vaa, Dd, Dd, Ce, Dd, Aa, Aa, Aa, Aa
Ha, Ha, Aa, Aa, Ms, Aa, Aa, Aa, Aa, Aa^Vaa, Aa, Dd, Aa, Aa, Aa, Aa, Aa, Dd^Es, Hd, Dd, Dd, Dd^Es, Dd, Ha, Dd, Aa, Dd, Dd, Dd, Ce, 2 Kea, Cea, Dd, Dd, Dd^Es, Dd
Aa, Aa, Aa, Ha, Ms, Ha, Ha, Aa, Ha, Aa, Aa, Aa, Ha, Ha, Ha, Aa, Aa, Dd, Dd, Dd, Aa, Aa, Aa, Dd, Aa, Dd, Dd^Es, Dd^Es, Aa, Cea, Cea, Cea, Dd, Dd, Dd^Es, Dd^Es
Aa, Aa, Ha^Fpa, Ha^Fpa, Ms^Xm, Ha, Ha, Ha, Ms, Ha, Ha, Ha, Ha^Fpa, Ms, Ms, Ha^Fpa, Hh^Fp, Aa, Dd^Es, Dd^Es, Aa, Ha, Ha, Aa, Aa, Dd^Es, Dd, Dd, Dd, Aa, Aa, Aa, Aa, Aa, Aa, Dd
Aa, Aa, Ha^Fpa, Ms, Ms^Xm, Ha^Fpa, Ha^Fpa, Ms, Ms^Xm, Ms, Ms, Ms, Ha^Fpa, Ms, Ms^Xm, Ms, Hh^Fp, Aa, Aa, Dd, Aa, Aa, Ha, Ha, Aa, Aa, Dd, Dd, Aa, Aa, Ha, Ha, Hd, Ha, Aa, Dd
Ha, Ha, Ms, Ms^Xm, Ms^Xm, Ms, Ms^Xm, Ms^Xm, Ms, Ms^Xm, Ms^Xm, Ms^Xm, Ms^Xm, Ms^Xm, Ms, Ms, Hh^Fp, Ss, Dd, Dd, Dd^Es, Aa, Aa, Ha, Aa, Dd^Es, Dd^Es, Dd, Aa, Hd, Mm, Mm, Dd, Dd^Es, Aa^Vaa, Aa
Ms, Ms, Ms, Ms, Ms^Xm, Ms^Xm, Ms, Ms, Ha, Ms, Ms, Ms, Ms, Ms, Ha^Fpa, Hh^Fp, Ss, Ss, Dd, Dd^Vdt, Dd, Aa, Dd^Es, Aa, Aa, Aa, Dd, Dd, Aa, Hd, Mm, Mm, Mm, Dd^Es, Dd^Es, Aa
Ms, Ms, Ms, Ms^Xm, Ms^Xm, Ms, Ha^Fpa, Ha^Fpa, Aa, Ha^Fpa, Ha^Fpa, Ha, Ha, Ha^Fpa, Aa, Aa, Dd, Ss, Ss, Dd, Ss, Dd, Dd, Dd, Dd, Dd, Dd, Dd, Aa, Hh^Fp, Hh^Fp, Mm, Mm, Hd, Aa, Dd^Es
Ms, Ms, Ms^Xm, Ms^Xm, Ms, Ha, Ai, Aa, Aa^Vaa, Aa, Aa, Aa, Aa, Aa, Aa, Dd^Es, Dd^Es, Ss, Hh^Fp, Hh^Fp, Hh^Fp, Ss, Ss, Ss, Ss, Ss, Hh^Fp, Dd, Dd, Hh^Fp, Aa, Mm, Aa, Aa, Aa, Dd^Es
Ms, Ms^Xm, Mm, Mm, Mm, Aa, Ai, Aa, Aa, Aa, Aa, Aa, Ha, Aa, Aa, Dd, Ai, Wwf, Ww, Mm, Mm, Hh^Fp, Hh^Fp, Hh^Fp, Hh^Fp, Hh^Fp, Hh^Fp, Ss, Ss, Dd, Dd, Aa, Aa, Aa, Aa, Aa
Ms, Ms^Xm, Mm, Mm, Hh^Fp, Hh^Fp, Aa, Ai, Ai, Ai, Aa, Ha, Aa, Aa, Dd, Ai, Wwf, Wwf, Ww, Ww, Ww, Mm, Mm, Mm, Hh^Fp, Md, Hh^Fp, Hh^Fp, Ss, Dd^Es, Dd^Es, Dd^Es, Aa, Aa, Dd^Es, Dd^Es
Mm, Mm, Mm, Hh^Fp, Ss, Hh^Fp, Ww, Ww, Ww, Ai, Ww, Aa, Ww, Ww, Ww, Dd, Wwf, Ww, Ww, Ww, Hh^Fp, Mm, Hh^Fp, Hh^Fp, Gll^Fp, Hh^Fp, Hh^Fp, Ss, Dd, Dd, Aa, Aa, Ha, Aa, Aa, Dd^Es
Hh^Fp, Mm, Hh^Fp, Hh^Fp, Ww, Ww, Ss, Dd^Es, Dd^Es, Ww, Ss, Ww, Aa, Ww, Dd^Es, Ss, Ss, Wwf, Wwf, Ww, Mm, Mm, Hh^Fp, Gll^Fp, Gll^Fp, Hh^Fp, Ss, Ss, Dd, Aa, Aa, Ha, Ms, Ha, Ha^Es, Aa
Ww, Hh^Fp, Ww, Ww, Hh^Fp, Ss, Dd^Es, Dd^Es, Dd^Es, Dd, Dd^Es, Aa, Aa, Aa, Dd^Es, Dd^Es, Ss, Ss, Aa, Mm, Hh^Fp, Mm, Hh^Fp, Gll^Vo, Gll^Fp, Hh^Fp, Ss, Dd, Dd, Dd^Es, Ha, Ha, Md, Ms, Ms, Ms
Ss, Ww, Hh, Hh^Fp, Hh, Dd^Rby, Hh^Fp, Hh^Fp, Hh^Fp, Dd^Es, Dd^Es, Aa, Aa, Dd^Es, Dd^Es, Ss, Ss, Hh^Fp, Hh^Fp, Aa, Hh^Fp, Mm, Hh^Fp, Hh^Fp, Hh^Fp, Hh^Fp, Ss, Ss, Dd, Dd^Es, Ha, Ms, Ha^Voa, Md, Md, Ms
Mm, Hh^Fp, Mm, Mm, 5 Hh^Fp, Hh^Fp, Mm, Mm, Hh^Fp, Aa, Dd^Es, Aa, Aa, Aa^Vaa, Dd, Dd^Es, Ss, Ss, Ss, Hh^Fp, Ss, Hh^Fp, Ss, Aa, Aa, Aa, Ss, Hh^Fp, Hh^Fp, Hh^Fp, Hh^Fp, Ha, Ha, Md, Md, Md
Ha^Fpa, Mm, Ha^Fpa, Hh^Fp, Ha^Fpa, Hh^Fp, Mm, Mm, Hh^Fp, Aa, Aa, Dd^Es, Aa, Dd, Aa, Ss, Ss, Ss, Ai, Ss, Ai, Ss, Ss, Ss, Ss, Ss, Ai, Ss, Dd, Ss, Ss, Aa, Aa, Hh^Fp, Hh^Fp, Hh^Fp
Ha^Fpa, Ha^Fpa, Ha, Ha^Fpa, Ms, Ha^Fpa, Ms, Mm, Hh^Fp, Aa, Ha, Aa, Aa, Aa, Ai, Ww, Ww, Ai, Aa, Ai, Aa, Dd^Rby, Dd, Ai, Ai, Ss, Ai, Dd, Ai, Ai, Ss, Ss, Ai, Aa, Ss, Ai
Ms, Ha, Ha^Vaa, Ms, Ms, Ms, Mm, Mm, Hh^Fp, Ha, Ha, Aa, Aa, Ai, Aa, Aa, Aa, Aa, Aa, Aa, Dd^Es, Dd^Es, Aa, Aa, Aa, Ss, Ai, Ai, Ss, Ss, Ai, Ss, Ss, Ss, Aa, Ss
Ms, Ms, Ms, Ms, Mm, Mm, Mm, Hh^Fp, Ha^Fpa, Ms, Ms, Ha, Ha^Fpa, Ai, Ha^Fpa, Ha^Fpa, Ha, Aa, Aa, Aa, Aa, Aa, Aa, Aa, Hh^Fp, Hh^Fp, Hh^Fp, Ai, Aa, Aa, Aa, Aa, Ss, Aa, Aa, Aa
Ms, Ms, Mm, Mm, Mm, Mm, Hh^Fp, Hh^Fp, Ms, Ha^Fpa, Ms, Ms, Ha^Fpa, Ai, Ha^Fpa, Ms, Ms, Ha, Ha, Aa, Ha^Fpa, Hh^Fp, Hh^Fp, Hh^Fp, Hh^Fp, Hh^Fp, Csz, Csz, Csz, Aa, Aa, Aa, Aa, Ss, Aa, Aa
Mm, Mm, Mm, Mm, Mm, Hh^Fp, Ms, Ww, Ai, Ai, Ai, Ha^Fpa, Ai, Ai, Ms, Ms, Ms, Ha^Vaa, Ms, Ha, Ms, Hh^Fp, Ms, Hh^Fp, Ha, Ha, Csz, 1 Csz^Ksy, Csz, Ha, Ha, Ha, Hh^Fp, Ss, Ss, Ai
Mm, Mm, Mm, Mm, Ms, Ms, Ha^Fpa, Ha^Fpa, Aa, Aa, Aa, Ai, Ai, Ha^Fpa, Ms, Ms, Ms, Ms, Ms, Ms, Ms, Ms, Ms, Ms, Ha, Aa, Aa, Csz, Ha, Ha, Ms, Ms, Hh^Fp, Ss, Ai, Ai
Mm, Mm, Mm, Mm, Ms, Ms, Ha^Fpa, Aa, Ai, Ai, Ai, Ai, Ha^Fpa, Ha^Fpa, Ms, Ms, Ms, Ms, Ms, Ms, Ms, Ms, Ms, Ha, 3 Ha, Aa, Aa, Ha, Ms, Ms, Ms, Ha, Ha, Ai, Ha, Aa
Mm, Mm, Mm, Mm, Ms, Ha, Aa, Aa, Aa, Ai, Aa, Aa, Ha^Fpa, Ms, Ms, Ms, Mm, Ha, Ha, Ha, Ms, Ms, Ms, Ha, Aa, Aa, Aa, Ha, Ms, Ms, Ms, Ms, Ha, Ha, Ha, Ha
Mm, Mm, Mm, Ms, Ha^Fpa, Ha, Aa, Aa, Qxu, Aa, Ha^Fpa, Ha^Fpa, Ms, Ms, Ms, Ms, Mm, Md, Md, Md, Mm, Ms, Ha, Ha, Aa, Dd^Es, Dd^Es, Aa, Ha, Ha, Ha, Ha^Voa, Ha, Ms, Ms, Ms
Mm, Mm, Ms, Ha^Fpa, Ha^Fpa, Ha^Fpa, Aa, Qxu, Qxu, Ha^Fpa, Ms, Ms, Ms, Ms, Ms, Ms, Ms, Mm, Ms, Mm, Ha, Ha, Aa, Aa, Dd^Es, Dd^Es, Aa, Aa, Ha, Ms, Ms, Ha, Ms, Ms, Ms, Ms
Ms, Ms, Ha^Fpa, Ha^Fpa, Aa, Aa, Aa, Qxu, Qxu, Ha, Ha, Ms, Ms, Ms, Ms, Ms, Ms, Ms, Ms, Ha, Aa, Aa, Dd^Es, Dd^Es, Aa, Aa, Ha, Ha, Ms, Ms, Ms, Ms, Ha, Ha, Ms, Ms
