border_size=1
usage=map

Ww, Ww, Dd^Ftd, Dd^Ftd, Dd^Ftd, Gs^Ftp, Gs^Ft, Gs, Re, Gs, Gs, Gs^Ft, Gs^Ft, Ww, Ss, Gs^Ft, Gs^Ft, Gs^Ft, Ss, Co, Rr, Rr, Rr, Rr, Rr, Rp, Rr, Rr, Rr, Rr, Rr, Co, Ss, Gs^Ft, Ss, Gs^Ft, Ww, Gs^Ft, Gs^Ft, Gs^Ft, Gs^Ft, Gs^Ft, Gs^Ft, Gs^Ft, Gs, Rd, Gs, Gs, Gs, Gs, Gs, Gs, Gs, Gs
Ww, Ww, Dd^Ftd, Dd, Dd^Ftd, Gs^Ftp, Gs, Gs, Re, Gs, Gs, Gs^Ft, Gs^Ft, Ww, Ss, Gs^Ft, Gs^Ft, Ss, Rr, Rr, Rr, Rr, Rr, Rr, Rr, Rr, Rr, Rr, Rr, Rr, Rr, Rr, Rr, Gs^Ft, Ss, Ww, Ss, Ww, Ww, Ww, Ww, Ww, Ww, Gs^Ft, Rd, Rd, Gs, Gs^Gvs, Gs, Gs^Vo, Gs, Gs, Gs^Es, Rd
Ww, Ww, Dd^Ftd, Dd, Dd, Gs^Ftp, Gs, Gs, Re, Gs, Gs, Gs^Ft, Gs^Ft, Ww, Ss, Ss, Gs^Ft, Gs^Ft, Rr, Rr, Rr, Rr^Vo, Rr, Rr, Co, Co, Co, Rr, Rr, Rr^Vo, Rr, Rr, Rr, Gs^Ft, Gs^Ft, Ss, Ss, Ss, Gs, Gs, Gs, Gs, Rd, Wo^Bsb/, Gs, Gs, Co, Gs, Gs, Gs^Es, Gs^Es, Gs, Gs^Es, Gs
Ww, Ww, Ww, Dd^Ftd, Dd, Gs^Ft, Gs^Ftp, Gs, Re, Gs, Gs, Gs^Ft, Gs^Ft, Ww, Ww, Ss, Gs^Ft, Rr, Rr, Rr, Rr, Rr, Rr, Rr, Co, 2 Ko, Co, Rr, Rr, Rr, Rr, Rr, Rr, Rr, Gs^Ft, Ss, Gs, Gs, Gs^Ft, Gs^Ft, Gs, Rd, Gs^Ft, Ww, Co, 3 Ko, Co, Hh, Gs, Gs^Es, Gs, Gs, Gs, Gs
Ww, Ww, Ww, Dd^Ftd, Dd, Gs^Ft, Gs^Ftp, Gs, Gs, Re, Gs, Gs, Gs^Ft, Gs^Ft, Ww, Ss, Gs^Ft, Gs^Ft, Rr, Rr, Rr, Rr, Rr, Rr, Rr, Co, Rr, Rr, Rr, Rr, Rr, Rr, Rr, Gs^Ft, Ss, Ww, Gs, Hh^Es, Gs^Ft, Gs^Ft, Gs, Rd, Gs^Ft, Ww, Ww, Co, Gs, Gs, Gs, Gs, Rd, Gs, Rd, Rd
Ww, Ww, Ww, Dd^Ftd, Dd^Es, Gs^Ft, Gs^Ftp, Gs^Vo, Gs, Re, Gs, Gs, Gs^Ft, Gs^Ft, Ww, Ss, Ss, Gs^Ft, Ss, Rr, Rr, Rr, Rr, Rr, Rr, Rr, Rr, Rr, Rr, Rr, Rr, Rr, Ss, Gs^Ft, Ww, Ww, Gs, Hh, Gs^Ft, Gs^Ft, Gs, Rd, Gs^Ft, Gs^Ft, Ww, Gs, Gs, Gs, Rd, Rd, Dd, Rd, Dd^Es, Dd
Ww, Ww, Ww, Dd^Ftd, Dd, Gs^Ft, Gs^Ft, Gs, Gs, Re, Re, Gs, Gs, Gs^Ft, Gs^Ft, Ww, Ss, Gs^Ft, Re, Co, Ss, Rr, Rr, Rr, Rr, Rr, Rr, Rr, Rr, Rr, Ss, Co, Re, Gs^Ft, Ww, Gs, Gs^Vo, Gs, Gs, Gs, Rd, Rd, Rd, Gs^Ft, Gs^Ft, Ww, Ww^Bsb/, Rd, Dd, Dd, Dd^Vo, Dd^Es, Dd, Dd
Ww, Ww, Ww, Dd^Ftd, Dd^Ftd, Dd, Gs^Ft, Gs^Ft, Gs, Gs, Re, Gs, Gs, Gs^Ft, Gs^Ft, Ww, Co, Re, Gs^Ft, Gs^Ft, Gs^Ft, Ss, Ss, Rr, Rr, Rr, Rr, Rr, Ss, Ss, Gs^Ft, Gs^Ft, Gs^Ft, Re, Co, Gs, Gs, Gs, Rd, Rd, Hh, Gs, Gs, Rd, Rd, Rd, Ww, Dd, Dd, Dd^Es, Dd^Es, Dd, Dd, Dd^Ftd
Ww, Ww, Ww, Ww, Dd^Ftd, Dd^Es, Dd^Ftp, Gs^Ft, Gs^Ft, Gs, Re, Gs, Gs, Gs, Re, Re, Gs^Ft, Ww, Ww, Gs^Ft, Gs^Ft, Ss, Ww, Ss, Ss, Rr, Ss, Ss, Gs^Ft, Gs^Ft, Gs^Ft, Gs^Ft, Ww, Ww, Gs^Ft, Rd, Rd, Rd, Gs, Hh, Mm, Hh, Hh, Gs, Rd, Gs^Ftp, Gs^Ftp, Ww, Dd, Dd, Dd^Ftd, Dd^Ftd, Dd^Ftd, Dd^Ftd
Ww, Ww, Ww, Ww, Dd^Ftd, Dd^Es, Dd^Es, Gs^Ft, Gs^Ft, Gs, Gs, Re, Re, Re, Gs^Ft, Gs^Ft, Gs^Ft, Ss, Ss, Ww, Ww, Ww, Gs^Ft, Gs^Ft, Gs^Ft, Co, Gs^Ft, Gs^Ft, Gs^Ft, Gs^Ft, Ww, Ww, Gs^Ft, Gs^Ft, Hh, Gs^Ft, Rd, Gs, Gs^Ftp, Hh, Mm, Hh, Gs^Es, Gs^Ftp, Rd, Hh, Gs^Ft, Ww, Ww, Ww, Ww, Dd^Ftd, Dd^Ftd, Dd^Ftd
Ww, Ww, Ww, Ww, Ww, Dd^Ftd, Dd^Es, Gs^Ft, Gs^Ft, Gs^Ft, Gs, Re, Gs, Gs, Gs, Gs^Ft, Gs^Ft, Gs^Ft, Gs^Ft, Ww, Ww, Ss, Ww, Gs^Ft, Gs^Ft, Re, Gs^Ft, Gs^Ft, Ww, Ww, Gs^Ft, Ww^Ewl, Gs, Hh^Es, Gs, Gs^Ft, Rd, Gs, Gs^Ft, Hh, Mm, Hh^Es, Gs^Es, Rd, Hh^Es, Hh, Hh^Ftp, Gs^Ftp, Ss, Ss, Ww, Ww, Ww, Ww
Wo, Ww, Ww, Ww, Ww, Dd^Ftd, Dd^Ftd, Dd, Gs^Ft, Gs^Ft, Gs, Re, Gs, Gs^Vo, Gs, Gs^Ft, Gs^Ft, Gs^Ft, Gs^Ft, Ss, Ww, Ww, Ss, Ww, Ww, Re, Ww, Ww, Gs^Ft, Gs^Ft, Gs, Gs, Gs, Gs, Gs, Rd, Gs, Gs, Gs^Vo, Hh, Hh, Hh^Es, Gs, Rd, Hh^Es, Mm, Mm, Hh, Gs^Ftp, Ss, Ww, Dd^Ftd, Dd^Ftd, Dd^Ftd
Wo, Ww, Ww, Ww, Ww, Ww, Dd^Ftd, Dd, Gs^Ft, Gs^Ft, Gs^Ft, Re, Re, Gs, Gs, Gs^Ft, Gs^Ft, Gs^Ft, Gs^Ft, Gs^Ft, Ww, Ww, Ww, Gs, Gs, Co, Rd, Gs^Ft, Gs, Gs, Gs^Gvs, Gs^Gvs, Gs, Hh, Gs, Rd, Rd, Gs, Gs, Gs^Ft, Gs^Ftp, Gs, Ss, Rd, Gs^Ft, Hh^Es, Hh, Hh, Hh^Es, Dd^Rby, Ss, Ww, Ww, Dd^Ftd
Wo, Ww, Ww, Ww, Ww, Ww, Ww, Dd^Ftd, Dd^Es, Gs^Ft, Gs^Ft, Gs, Gs, Re, Re, Gs, Gs^Ft, Gs^Ft, Gs^Ft, Gs^Ft, Gs^Ft, Ww, Ww, Ss, Ss, Gs, Gs, Rd, Rd, Gs, Gs, Gs, Hh, Hh^Es, Gs, Gs, Rd, Gs, Gs, Ss, Ss, Ss, Ss, Ss^Bsb|, Ss, Gs^Ft, Dd^Es, Hh^Es, Dd^Es, Dd^Es, Ss, Ww, Dd, Dd^Ftd
Wo, Wo, Ww, Ww, Ww, Ww, Ww, Dd^Ftd, Dd^Ftd, Gs^Ft, Dd^Es, Gs^Ft, Gs^Ft, Gs, Re, Gs, Gs, Gs^Ft, Gs^Ft, Gs^Ft, Gs^Ft, Gs, Ss, Ww, Ww, Ss, Ss, Gs, Gs, Rd, Rd, Gs, Gs, Hh^Es, Gs, Gs, Gs, Rd, Gs, Gs^Ft, Gs^Ft, Ss, Gs, Ss^Bsb|, Ss, Ss, Ss, Dd^Es, Ss, Ss, Ww, Ww, Ww, Dd
Wo, Wo, Wo, Ww, Ww, Ww, Ww, Ww, Dd^Ftd, Dd, Dd, Gs^Ft, Gs, Gs, Gs, Re, Re, Gs, Gs, Gs^Ft, Gs^Ft, Gs, Gs, Ss, Ss, Ww, Ss, Gs^Ft, Gs^Ft, Gs, Gs, Rd, Rd, Gs, Gs, Gs^Vo, Gs, Rd, Rd, Gs, Gs, Gs, Gs, Rd, Dd, Ss, Ss, Ss, Ss, Ss, Ww, Ww, Wo, Ww
Wo, Wo, Wo, 1 Ww, Ww, Ww, Ww, Ww, Ww, Dd^Ftd, Dd^Ftd, Dd, Dd^Es, Gs^Ft, Gs^Ft, Gs, Gs, Re, Gs, Gs^Ft, Gs^Ft, Gs, Gs, Gs^Ft, Ss, Ww, Ww, Ss, Gs^Ft, Gs^Ft, Gs^Ft, Gs, Rd, Gs, Gs, Gs, Gs, Gs, Rd, Gs, Gs^Vo, Gs, Rd, Rd, Dd^Es, Ss, Ww, Ww, Ww, Ww, Wo, Wo, Ww, Ww
Wo, Wo, Wo, Wo, Wo, Ww, Ww, Ww, Ww, Dd^Ftd, Dd^Ftd, Dd, Dd, Gs^Ft, Dd^Es, Gs, Gs, Re, Re, Gs, Gs, Gs, Gs, Gs, Gs^Ft, Ss, Ww, Ss, Ss, Gs^Ft, Gs^Ft, Gs, Gs, Rd, Gs, Gs^Ftp, Gs, Rd, Gs, Gs, Gs, Gs, Rd, Dd, Ss, Ss, Ww, Ww, Wo, Wo, Ww, Ww, Dd^Vhs, Dd
Wo, Wo, Wo, Wo, Wo, Wo, Wo, Ww, Ww, Ww, Dd^Ftd, Dd^Ftd, Dd^Ftd, Dd, Dd, Dd^Es, Dd^Es, Gs, Gs, Re, Gs, Gs^Vo, Gs, Gs, Gs, Ss, Ww, Ss, Ss, Ss, Gs^Ft, Gs^Ft, Gs, Rd, Gs, Gs^Ftp, Gs, Rd, Gs, Gs^Gvs, Gs, Rd, Dd, Dd^Es, Ss, Ss, Ww, Ww, Ww, Ww, Ww, Ww^Bw\, Dd, Dd^Es
Ww, Wo, Wo, Wo, Wo, Wo, Wo, Ww, Ww, Ww, Ww, Dd^Ftd, Dd^Ftd, Chw, Dd, Dd, Dd^Es, Gs^Es, Gs, Re, Re, Gs, Gs, Gs^Ft, Gs, Ss, Ss, Ww, Ww, Gs^Ft, Gs, Gs, Gs, Rd, Gs, Gs, Rd, Rd, Rd, Gs, Rd, Rd, Dd, Ss, Ss, Ww, Ww, Wo, Wo, Ww, Chw, Dd^Ftd, Dd^Ftd, Dd^Es
Ww, Ww, Ww, Wo, Wo, Wo, Wo, Wo, Wo, Ww, Ww, Ww, Ww, Ww, Chw, Dd, Dd^Es, Dd, Dd^Es, Gs, Gs, Re, Gs, Gs^Ft, Gs^Ft, Gs, Gs, Ss, Ww, Gs^Ft, Gs, Gs^Vo, Gs, Rd, Rd, Rd, Dd, Dd^Es, Dd^Es, Rd, Dd^Es, Dd, Dd^Vo, Dd, Dd^Ftd, Ss, Ww, Wo, Wo, Ww, Chw, 5 Dd^Ftd, Dd^Ftd, Ww
Ww, Ww, Ww, Wo, Wo, Wo, Wo, Wo, Wo, Wo, Ww, Ww, Ww, Ww, Ww, Dd^Ftd, Dd^Ftd, Dd^Es, Dd, Dd^Es, Gs^Es, Re, Re, Gs, Gs, Gs, Gs, Gs^Ft, Ww, Gs^Ft, Gs^Ft, Gs, Rd, Rd, 4 Ke, Cd, Dd, Dd, Dd, Dd^Es, Dd, Dd, Dd, Dd^Es, Dd^Ftd, Ss, Ww, Ww, Wo, Ww, Ww, Dd^Ftd, Ww, Ww
Ww, Ww, Ww, Ww, Ww, Wo, Wo, Wo, Wo, Wo, Wo, Ww, Ww, Ww, Ww, Ww, Dd^Ftd, Dd^Ftd, Dd^Ftd, Dd, Dd^Es, Gs, Gs, Re, Re, Gs, Gs^Ft, Gs^Ft, Ww^Bw/, Rd, Re, Re, Dd, Cd, Cdr, Cdr, Wwf, Wwf, Dd, Dd, Ww, Dd^Ftd, Dd^Ftd, Dd^Ftd, Dd^Ftd, Ww, Ww, Ww, Wo, Wo, Ww, Ww, Ww, Wo
Gd^Fts, Ww, Ww, Ww, Ww, Ww, Wo, Wo, Wo, Wo, Wo, Wo, Wo, Wo, Ww, Ww, Ww, Dd^Ftd, Dd^Ftd, Dd, Dd^Es, Dd^Es, Dd, Gs, Gs^Vo, Re, Re, Re, Ww, Gs^Ft, Gs^Ft, Gs^Ft, Ss, Wwf, Wwf, Wwf, Dd, Dd, Dd^Ftd, Dd^Ftd, Ww, Ww, Ww, Ww, Ww, Ww, Ww, Wo, Wo, Wo, Wo, Ww, Wo, Wo
Gd^Fts, Ww, Ww, Ww, Ww, Ww, Ww, Wo, Wo, Wo, Wo, Wo, Wo, Wo, Wo, Ww, Ww, Ww, Dd^Ftd, Dd^Ftd, Dd^Ftd, Dd, Dd^Es, Dd^Es, Dd, Dd^Es, Dd^Ftd, Dd^Ftd, Ww, Ss, Ss, Ss, Ww, Wwf, Ww, Ww, Ww, Ww, Ww, Ww, Ww, Ww, Ww, Ww, Wo, Ww, Wo, Wo, Wo, Wo, Wo, Wo, Wo, Wo
Gs, Gd^Fts, Gd^Fts, Ww, Ww, Ww, Ww, Wo, Ww, Wo, Wo, Wo, Wo, Wo, Wo, Ww, Ww, Ww, Ww, Dd^Ftd, Dd^Ftd, Dd^Ftd, Dd^Ftd, Dd^Ftd, Dd^Ftd, Dd^Ftd, Dd^Ftd, Dd^Ftd, Dd^Ftd, Ww, Ww, Ww, Dd^Ftd, Ww, Ww, Ww, Ww, Ww, Wo, Ww, Wo, Wo, Wo, Wo, Wo, Wo, Wo, Wo, Wo, Wo, Wo, Wo, Wo, Wo
Gd, Gs, Gs, Gd^Fts, Ww, Ww, Ww, Ww, Ww, Ww, Ww, Wo, Wo, Wo, Wo, Wo, Wo, Ww, Ww, Ww, Ww, Ww, Ww, Ww, Ww, Ww, Ww, Dd^Ftd, Ww, Dd^Ftd, Ww, Dd^Ftd, Ww, Ww, Ww, Wo, Wo, Wo, Wo, Wo, Wo, Wo, Wo, Wo, Wo, Wo, Wo, Wo, Wo, Wo, Wo, Wo, Wo, Wo
Gll, Gd, Gs^Es, Gd^Fts, Gd^Fts, Ww, Gd^Fts, Ww, Ww, Ww, Ww, Wo, Wo, Wo, Wo, Wo, Wo, Ww, Ww, Ww, Ww, Ww, Ww, Ww, Ww, Ww, Ww, Ww, Ww, Ww, Ww, Ww, Ww, Ww, Wo, Wo, Wo, Wo, Wo, Wo, Wo, Wo, Ww, Wo, Ww, Wo, Ww, Ww, Ww, Ww, Ww, Ww, Ww, Ww
Hhd^Fmf, Gll, Gll, Gs, Gs, Gs, Gs, Ww, Gd^Fts, Ww, Ww, Ww, Ww, Wo, Wo, Wo, Wo, Wo, Wo, Wo, Wo, Ww, Wo, Ww, Wo, Ww, Wo, Ww, Wo, Wo, Wo, Wo, Wo, Wo, Wo, Wo, Wo, Wo, Ww, Ww, Ww, Ww, Ww, Ww, Ww, Ww, Ww, Ww, Ww, Ww, Ww, Ww, Ww, Ww
Hhd^Fmf, Gll^Fmf, Gll, Gs^Es, Gd^Es, Gs, Gs^Vht, Gs, Gd^Fts, Ww, Ww, Ww, Ww, Wo, Wo, Wo, Wo, Wo, Wo, Wo, Wo, Wo, Wo, Wo, Wo, Wo, Wo, Wo, Wo, Wo, Wo, Wo, Wo, Wo, Wo, Wo, Ww, Wo, Ww, Ww, Ww, Ww, Ww, Ww, Gd^Fts, Ww, Gd^Fts, Gll, Gll, Ww, Gll, Gll, Gll, Gll
Hhd^Fmf, Hhd^Fmf, Gll^Fmf, Gll, Gd, Gs, Gs, Gs, Gs, Gd^Fts, Ww, Ww, Ww, Ww, Ww, Wo, Ww, Wo, Wo, Wo, Wo, Wo, Wo, Wo, Wo, Wo, Wo, Wo, Wo, Wo, Wo, Wo, Wo, Ww, Ww, Ww, Ww, Ww, Ww, Ww, Gd^Fts, Ww, Gll, Gd^Fts, Gs^Vht, Gd^Fts, Gll, Gll, Hhd^Fmf, Gll, Hhd^Fmf, Hhd^Fmf, Hhd^Fmf, Gll^Fdf
Hhd^Fmf, Hhd^Fmf, Hhd^Fmf, Gll, Gd, Gd, Gs^Es, Gs, Gs, Gd^Fts, Gd^Fts, Ww, Ww, Ww, Ww, Ww, Ww, Ww, Ww, Ww, Ww, Wo, Wo, Wo, Wo, Wo, Wo, Wo, Ww, Wo, Ww, Ww, Ww, Ww, Ww, Ww, Ww, Ww, Gd^Fts, Gd^Fts, Gll, Gll, Hhd^Fmf, Gll, Gll, Gll, Gll^Fmf, Hhd^Fmf, Mm, Hhd^Fmf, Mm, Mm, Mm, Mm
Hhd^Fmf, Hhd^Fmf, Hhd^Fmf, Gll^Fmf, Gll, Gd, Gll, Gs^Es, Gd^Es, Gs, Gs, Gd^Fts, Gd^Fts, Gd^Fts, Gd^Fts, Ww, Gd^Fts, Ww, Ww, Ww, Ww, Ww, Ww, Ww, Ww, Wo, Ww, Ww, Ww, Ww, Ww, Ww, Gd^Fts, Ww, Gd^Fts, Gd^Fts, Gd^Fts, Gd^Fts, Hhd^Fmf, Hhd^Fmf, Hhd^Fmf, Hhd^Fmf, Gll^Fmf, Gll, Hhd^Fmf, Hhd^Fmf, Hhd^Fmf, Hhd^Fmf, Mm, Mm, Mm, Mm, Ms, Ms
Hhd^Fmf, Hhd^Fmf, Hhd^Fmf, Hhd^Fmf, Gll^Fmf, Gll, Gll, Gll, Gll, Gll, Gll, Gll, Gll, Gll, Gll, Gd^Fts, Gs, Gd^Fts, Gd^Fts, Ww, Gd^Fts, Ww, Ww, Ww, Ww, Ww, Ww, Ww, Ss, Ww, Gd^Fts, Gd^Fts, Gd^Fts, Gd^Fts, Gll, Gs, Gg^Vht, Gll, Hhd^Fmf, Hhd^Fmf, Hhd^Fmf, Hhd^Fmf, Hhd^Fmf, Hhd^Fmf, Mm, Mm, Mm, Mm, Mm, Mm, Ms, Ms, Ms, Ms
