border_size=1
usage=map

Xuc, Xuc, Ss, Ss, Ww, Ww, Ww, Ww, Ww, Ww, Ww, Ww, Ww, Ds, Ds, Ds, Gg, Gg, Gg, Gs^Ft, Gs^Ft, Gs^Ft, Gs^Ft, Gs^Ft, Gs^Ft, Gs^Ft, Gg, Gg, Gg, Gg, Xuc, Xuc, Xuc, Xuc, Xuc, Xuc, Uu, Uu, Uu
Wwg, Xuc, Xuc, Ss, Ss, Ss, Ss, Ww, Ss, Ss, Ss, Ww, Ww, Ds, Ds, Ds, Gg, Gg, Gs, Gg, Gg^Fet, Gs^Ft, Gs^Eff, Gg^Fet, Gg, Gg, Gg, Gg, Xuc, Xuc, Uu, Uu, Uu, Uu, Uu, Uu, Uu, Uu, Uu^Br/
Ww, Ww, Xuc, Ss, Xuc, Xuc, Xuc, Ss, Xuc, Xuc, Xuc, Ss, Gs^Ft, Ds, Ds, Gs^Ft, Gg^Fet, Gg, Gs^Ft, Gs, Gs, Gs^Eff, Gs, Gg^Eff, Gg, Gg, Gg, Gg, Xu, Uu^Uf, Uu, Uu^Vo, Uu, Uu, Uu^Br/, Uu^Br\, Uu^Br/, Uu^Br/, Urb
Ww, Wwg, Ss, Xuc, Urb, Ss, Ss, Xuc, Ww, Ww, Ww, Xuc, Xuc, Gs^Ft, Gs^Ft, Gs^Ft, Gs^Ft, Gs^Ft, Gs, Gs, Gs, Gs^Vl, Gs, Gg, Gg^Gvs, Gg^Gvs, Gg, Gg, Xu, Gs^Ft, Uu, Uu, Co, Co, Co, Uu, Urb, Urb, Urb
Ww, Ss, Ss, Xuc, Urb, Urb, Wwf, Xuc, Ww, Ww^Vhs, Ww, Ww^Ewl, Ss, Xuc, Xuc, Gs^Ft, Gs^Ft, Gs^Ft, Gg^Fet, Gg, Rr^Vhc, Gs^Ft, Gg, Gg, Gg, Gg, Gg, Gg, Xu, Gs^Ft, Uu, Uu, Co, 2 Ke, Co, Urb, Urb, Urb, Ss
Wwg, Wwg, Ss, Xuc, Xuc, Urb, Wwf, Xuc, Cud, Ww, Wwf, Ss, Urb, Ss, Ss, Xuc, Xuc, Gs^Ft, Gs^Ft, Gs^Ft, Gs^Ft, Gs^Ft, Gs^Ft, Gg, Gs^Ft, Gs^Ft, Gs^Ft, Xu, Gs^Ft, Gs^Ft, Urb, Urb, Ss, Co, Gs^Ft, Urb, Ss, Ss, Xu
Ww, Wwg, Ss^Vm, Ss, Ss, Ss, Wwf, Xu, Xu, Wwf, Urb, Uu^Uf, Uu, Urb, Urb, Ss, Ss, Xuc, Xuc, Gs^Ft, Gs^Ft, Gs^Ft, Gs^Ft, Gs^Ft, Gs^Ft, Gs^Ft, Xu, Xu, Gs^Ft, Gs^Ft, Urb, Urb, Ss, Ss, Urb, Urb, Ss, Xuc, Xu
Ww, Ww, Ww, Ss, Wwg, Ss, Ss, Wwf, Xu, Ss, Urb, Uu, Xu, Uu, Uu, Urb, Urb, Ss, Ss, Xuc, Xuc, Gs^Ft, Xuc, Gs^Ft, Xuc, Xu, Gs^Ft, Gs^Ft, Ss, Urb^Vo, Urb, Ss, Ss^Bw/, Ss^Bw/, Ss, Ss, Ss, Ss, Xu
Wwg, Wwg, Wwg, Ww, Ww, Wwg, Wwf, Ss, Xu, Ss, Urb, Uu, Uu, Xuc, Cud, Uu, Uu, Ss^Bw\, Ss^Bw\, Ss, Ss, Xuc, Ss, Xuc, Ss, Ss, Ss, Ss, Urb, Urb, Ss, Urb, Ss, Ss, Uu, Ss, Ss, Ss, Xu
Xuc, Xuc, Wwg, Ww, Wwg, Wwg, Ss, Ss, Xu, Ss, Xu, Urb, Xu, Xuc, Xuc, Xuc, Xuc, Ss, Uu, Urb, Urb, Ss, Urb, Ss, Ss, Ww^Ewl, Ss^Bw/, Ss^Bw/, Ss, Ss, Xuc, Ss, Uu^Uf, Uu^Uf, Xu, Uu, Ss, Ss, Xu
Xuc, Wwg, Wwg, Wwg, Wwg, Ss, Ss, Uu^Emf, Uu, Xu, Ss, Xu, Urb, Uu, Uu, Uu, Uu, Xuc, Xuc, Uu, Uu, Urb, Uu, Urb, Urb, Urb, Ss, Ss, Xuc, Xuc, Uu, Xuc, Xu, Xu, Uu, Uu, Ss, Ss, Xu
Xuc, Wwg, Wwg, Wwg, Chw, Wwg, Ss, Ss, Uu, Xu, Ss, Urb, Ss, Urb, Urb, Urb, Urb, Uu, Uu, Xuc, Xuc, Uu, Xuc, Uu, Uu, Uu, Xuc, Xuc, Uu, Uu, Rd, Uu, Uu, Uu, Ss, Ss, Uu^Vo, Uu, Xu
Xuc, Wwg, Wwg, Chw, 4 Khw, Chs, Ss, Ss, Ss, Xuc, Cud, Wwf, Xuc, Ss, Ss, Ss, Ss, Urb, Urb, Uu^Vo, Xuc, Cud, Xuc, Xuc, Xuc, Xuc, Uu, Uu, Rd, Rd, Dd^Es, Rd, Rd, Dd^Es, Ss, Ss, Uu, Uh, Xu
Ss, Ss, Ss, Chs, Chs, Chs, Urb, Ss, Ss, Xuc, Xuc, Xuc, Cud, Xuc, Xuc, Xuc, Ss, Urb, Uu, Uu^Vo, Xuc, Xuc, Uu, Uu, Uu, Uu, Rd, Rd, Dd^Es, Dd^Es, Dd^Es, Dd^Es, Rd, Dd^Es, Ww^Ewl, Xu, Xu, Xuc, Xu
Ww, Ss, Ss^Vhs, Ss, Uu, Urb, Uu^Uf, Urb, Urb, Ss, Ss, Urb, Urb, Xuc, Ss, Ss, Urb, Urb, Uu, Xuc, Uu^Vo, Uu, Urb, Uu, Uu, Rd, Rd, Dd^Vo, Dd^Es, Dd^Es, Dd^Es, Rd, Dd^Es, Dd^Es, Ss, Ww^Ewl, Ss, Xuc, Xu
Ww, Ss, Ss, Uu, Uu, Urb, Uu, Uu, Uu, Urb, Ss, Ss, Ss, Xuc, Ss, Urb, Urb, Uu, Xuc, Xuc, Xuc, Urb, Uu, Uu, Xuc, Xuc, Xuc, Rd, Rd, Dd^Es, Rd, Rd, Rd, Dd, Dd, Ss, Ss, Xuc, Xu
Ww, Ww^Ewl, Ss, Xuc, Uu, Urb, Uu, Xuc, Uu, Urb, Urb, Urb, Ss, Xuc, Ss, Ss, Urb, Cud, Xuc, Dd^Vo, Dd, Xuc, Xuc, Xuc, Dd, Dd^Es, Dd^Es, Xuc, Xuc, Co, Co, Dd^Es, Dd^Es, Rd, Dd, Ss, Ss^Vo, Ss, Xu
Ww^Ewl, Ww^Ewl, Ss, Xuc, Uu, Urb, Uu, Xuc, Uu, Uu, Urb, Urb, Urb, Ss, Urb, Ss, Urb, Xuc, Ss, Dd, Rd, Dd^Es, Dd, Dd, Rd, Rd, Rd, Dd, Dd^Es, Xuc, Co, Xuc, Dd^Es, Rd, Rd, Dd, Ss, Ss, Xu
Ss, Ww^Ewf, Ss, Xu, Uu, Urb, Uu, Xuc, Uu, Uu^Vo, Uu, Urb, Urb, Urb, Urb, Urb, Urb, Xuc, Ss, Rd, Ds^Uf, Rd, Rd, Rd, Dd^Es, Dd, Dd^Es, Rd, Dd^Es, Xuc, 3 Ko, Xuc, Xuc, Dd^Es, Rd, Dd, Dd^Es, Ss, Xu
Ss, Ww^Ewl, Ss, Xuc, Uu, Urb, Uu, Xuc, Xuc, Uu, Xuc, Uu, Uu, Urb, Uu, Uu, Uu, Xuc, Xuc, Ss, Ss, Ss, Ss, Dd^Es, Xuc, Xuc, Dd, Rd, Dd^Es, Xuc, Xuc, Co, Co, Dd^Es, Rd, Dd^Es, Dd^Es, Ss, Xu
Ss, Ss, Ss, Xuc, Uu, Urb, Urb, Uu, Uu, Xuc, Uu, Xuc, Xuc, Cud, Xuc, Xuc, Xuc, Xuc, Uu, Xuc, Xuc, Xuc, Xuc, Xuc, Uu^Vo, Xuc, Dd^Es, Rd, Dd, Xuc, Dd^Es, Co, Dd, Dd, Rd, Dd, Ss, Ss, Xu
Ss, Ss, Ss, Ss, Ss, Uu, Uu, Urb, Urb, Uu, Urb, Uu, Uu, Xuc, Uu, Uu, Uu, Uu, Urb, Uu, Uu, Xuc, Uu, Uu, Uu, Xuc, Dd^Es, Rd, Rd, Dd^Es, Rd, Dd^Es, Rd, Rd, Dd, Dd, Ss, Ss, Xu
Ss, Ss, Ss, Ss, Ss^Vhs, Ss, Uu, Urb, Urb, Urb, Urb, Urb, Urb, Uu, Urb, Urb, Urb, Urb, 1 Urb, Urb, Urb, Uu, Urb, Urb, Uu, Xuc, Xuc, Dd, Dd, Rd, Dd^Es, Rd, Dd, Dd^Es, Dd^Es, Ss, Ss, Xuc, Xu
Ss, Ss, Ss, Ss, Ss, Ss, Ss, Uu, Uu, Uu, Uu, Urb, Urb, Urb, Urb, Urb, Urb, Urb, Urb, Urb, Urb, Urb, Urb, Urb, Urb, Uu, Uu, Xuc, Ss, Dd, Ss, Dd, Ss, Dd^Es, Ss, Ss, Xuc, Xuc, Xu
Wwg, Ss, Wwg, Wwg, Wog, Ss, Wog, Ss, Ss, Ss, Ss, Uu, Uu, Urb, Uu, Uu, Uu, Uu, Uu, Uu, Uu, Urb, Uu, Urb, Urb, Urb, Uu, Xuc, Xuc, Ss, Ss, Ss, Ss^Vo, Ss, Ss, Ss, Xuc, Xuc, Uu
Ss, Wwg, Ss, Ss, Ss, Wog, Ss, Ss, Ss, Xuc, Xuc, Ss, Xuc, Uu, Xuc, Xuc, Xuc, Xuc, Xuc, Xuc, Xuc, Uu, Xuc, Uu, Urb, Urb, Urb, Uu, Uu, Xuc, Xuc, Ss, Ss, Ss, Xuc, Xuc, Uu, Uu, Urb
Wwg, Ss, Ss, Ss, Ss, Ss, Ss, Ss, Gs^Ft, Gs^Ft, Gs^Ft, Xuc, Gs^Ft, Xuc, Gs^Ft, Gs^Ft, Gs^Ft, Gs^Ft, Gs^Br/, Uu^Br/, Uu^Br\, Xuc, Xuc, Uu, Uu, Urb, Urb, Urb, Urb, Uu, Uu, Xuc, Xuc, Xuc, Uu, Uu, Urb, Urb, Uu
Wwg, Ss, Wwg, Ss, Wwg, Ss, Ss, Ss, Dd, Gs^Ft, Ds, Gs^Ft, Gs^Ft, Gs^Ft, Gs^Ft, Gs^Ft, Ds^Uf, Cd, Rd, Gs^Ft, Urb, Uu^Br\, Uu^Br\, Xuc, Xuc, Uu, Uu, Urb, Urb, Urb, Urb, Uu, Uu, Uu, Urb, Urb, Uu, Uu, Xu
Wwg, Wwg, Wwg, Wwg, Ww, Wwg, Wwg, Dd, Ds, Ds, Ds, Ds, Cd, Kd, Ds, Ds, Rd, Ds^Uf, Rd, Gs^Ft, Gs^Ft, Urb, Urb, Uu^Br\, Uu^Br\, Xuc, Xuc, Uu, Uu, Urb, Urb^Br\, Urb, Urb, Urb, Uu, Uu, Xu, Xu, Xu
Ww, Ww, Ww, Ww^Vm, Ww, Wwg, Ww, Ww, Ww, Ww, Ds, Ds, Ds, Rd, Rd, Rd, Ds^Uf, Rd, Cd, Gs^Ft, Gs^Ft, Gs^Ft, Urb, Urb, Urb, Uu^Br\, Uu^Br\, Xuc, Uu^Br/, Uu^Br/, Uu^Vo, Urb^Br\, Urb^Br\, Uu, Xu, Xu, Xu, Xu, Uu^Br/
Wwg, Wwg, Wwg, Wwg, Wwg, Ww, Ww, Ww, Ww, Ww, Ww, Ds, Ds, Ds, Ds, Ds, Gs^Ft, Cd, Gs^Ft, Gs^Ft, Gs^Ft, Gs^Ft, Uu, Urb, Urb, Urb, Urb, Uu^Br/, Urb, Uu, Urb, Urb, Urb, Uu^Br\, Uu^Br\, Xu, Uu^Br/, Uu^Br/, Xu
Ss, Wwg, Wwg, Wwg, Wwg, Wwg, Wwg, Wwg, Wwg, Ww, Ww, Ww, Ww, Ds, Ds, Ds, Gs^Ft, Gs^Ft, Gs^Ft, Gs^Ft, Xuc, Xuc, Xuc, Uu, Uu^Vo, Urb, Urb, Urb, Urb, Urb, Urb, Urb, Uu, Uu, Xu, Uu^Br\, Xu, Xuc, Xu
Ss, Ss, Ss, Ss, Ss, Wwg, Ss, Wwg, Wwg, Wwg, Ww, Ww, Ww, Ds, Ds, Gs^Ft, Gs^Ft, Gs^Vhc, Gs^Ft, Gs^Ft, Xuc, Xuc, Xuc, Uu, Uu, Uu, Uu, Uu, Uu, Uu, Uu, Uu, Xuc, Xu, Xuc, Xuc, Xuc, Xu, Xu
Ss, Ss, Ss, Ss, Ss, Ss, Ss, Wwg, Ss, Wwg, Wwg, Ww, Ww, Ww, Ds, Ds, Xuc, Gs^Ft, Xuc, Xuc, Xuc, Xuc, Xuc, Xuc, Xuc, Xuc, Xuc, Xuc, Xuc, Xuc, Xuc, Xuc, Xuc, Xuc, Xuc, Xuc, Xuc, Xuc, Xu
