border_size=1
usage=map

Hh^Ftp, Hh^Ftp, Dd, Dd, Dd, Dd, Ww, Ww, Ww, Dd, Ww, Dd, Dd, Dd, Ww, Wwt, Wwt, Wwt, Wwt, Wot, Wot, Wot, Wot, Wot, Wwt, Wwt, Wwt, Wwt, Wwt, Wwt, Ai, Ai, Aa, Ai, Aa, Aa, Ha^Fpa, Ha^Fpa
Hh^Ftp, Hh^Ftp, Dd, Dd, Dd, Ww, Wwt, Wwt, Dd, Dd, Dd, Ww, Dd, Dd, Dd, Wwt, Ww^Vm, Wwt, Wwt, Wwt, Wot, Wot, Wot, Wot, Wwt, Wwt, Wwt, Wwt, Ww, Ai, Ai, Ai, Ha, Aa, Ha, Aa, Ha^Fpa, Ha^Fpa
Hh^Ftp, Dd, Dd, Dd, Ww, Ww, Wwrt, Wwrt, Wwt, Dd, Wwrt, Wwrt, Wwrt, Wwt, Wwt, Wwt, Wwt, Wwt, Wwt, Wot, Wot, Wot, Wot, Wwt, Wwt, Wwt, Wwt, Ww, Gs, Gs, Hh, Ai, Ha^Fma, Ha, Mm, Ha, Mm, Ha^Fpa
Dd, Dd, Dd, Dd, Ww, Wwt, Wwrt, Wwt, Chw, Wwrt, Wwrt, Wwrt, Wwt, Wwrt, Wwrt, Wwrt, Wwrt, Wwrt, Wwrt, Chw, Wot, Wot, Wot, Wwt, Wwt, Wwt, Ww, Ww, Gs, Gs^Vhs, Gs, Ha, Mm, Mm, Mm, Hh^Fp, Mm, Mm
Rd, Dd, Dd, Ww, Wwt, Wwrt, Chw, Wwt, 2 Khw, Chw, Wwrt, Wwt, Ww^Vm, Wwrt, Wwrt, Wwrt, Wwrt, Wwrt, Wwt, Chw, Wot, Wot, Wot, Wot, Wwt, Ww, Gs, Gs, Hh, Hh, Ha, Ha^Fma, Mm, Mm, Mm, Ha^Fma, Mm, Mm
Aa, Rd, Dd, Ww, Wwrt, Wwrt, Ww^Ewl, Chw, Chw, Chw, Wwt, Wwt, Wwt, Wwt, Wwrt, Wwt, Wwrt, Wwt, Wwrt, Wwrt, Wot, Wot, Wot, Wwt, Wwt, Ww, Ww, Gs, Hh, Hh, Md, Mm, Mv, Mm, Mm, Ha^Fma, Mm, Ha^Fma
Aa, Rd, Dd, Ww, Ww, Wwrt, Wwt, Ww^Ewl, Wwt, Wwt, Wwrt, Wwrt, Wwrt, Wwrt, Wwrt, Wwrt, Wwt, Wwrt, Wot, Wot, Wot, Wot, Wot, Wot, Wwt, Wwt, Ww, Gs, Ww, Hh, Hh, Md, Md, Mm, Mm, Hh^Fp, Mm, Ha^Fma
Aa, Rd, Rd, Dd, Ss, Ww, Ww^Vm, Wwt, Wwt, Wwt, Wwrt, Wwrt, Wwt, Wwt, Wwrt, Wwt, Wot, Wwt, Wot, Wot, Wot, Wwt, Wwt, Wwt, Wwt, Wwt, Wwt, Ww, Gs, Ww, Hh, Mm, Mm, Mm, Mm, Mm, Ms^Vaa, Ms
Ha^Fda, Aa, Rd, Dd, Dd^Es, Ss, Ss, Ww, Wwt, Wwrt, Wwrt, Wwrt, Wwt, Wwrt, Wwrt, Wwt, Wot, Wot, Wot, Wot, Wwt, Wwt, Wwt, Wwrt, Wwrt, Wwt, Gs, Hh, Hh, Hh, Md, Mm, Mm, Mm, Mm, Ms, Ms, Ms
Ha^Fpa, Aa, Aa, Dd^Es, Dd, Dd, Ss, Ww, Ww, Wwt, Wwt, Wwt, Wwt, Wwt, Wwt, Wwt, Wot, Wot, Wot, Wwt, Wwt, Wwt, Wwrt, Wwrt, Ww, Ss, Gs, Hh, Hh^Vht, Hh, Mm, Md, Md, Mm, Mm, Mm, Mm, Ms
Ms, Ha^Fda, Aa, Rd, Dd, Ss, Ww, Ww, Ww, Wwt, Wot, Wwt, Wot, Wwt, Wwt, Wot, Wot, Wot, Wwt, Wwt, Wwrt, Wwt, Wwrt, Wwrt, Ww, Gs, Gs, Hh, Hh, Hh, Hh^Fp, Mm, Mm, Mm, Mm, Mm, Ha^Fpa, Ha^Fpa
Ms, Ha^Fda, Aa, Rd, Dd, Ss, Ss, Ww, Ww, Wwt, Wwt, Wot, Wot, Wot, Wot, Wot, Wot, Wot, Wwt, Wwrt, Wwrt, Wwrt, Wwrt, Wwrt, Ss, Gs, Aa, Gs, Gs, Gs, Gs, Hh^Fp, Mm, Mm, Hh^Fp, Hh^Fp, Ha^Fma, Ha^Fpa
Ha^Fda, Ha^Vaa, Aa, Dd, Ss, Ss, Ww, Ww, Wwr, Ww, Ww, Wot, Wot, Wot, Wot, Wot, Wot, Wwt, Wwt^Vm, Wwt, Wwrt, Wwrt, Wwrt, Wwf, Wwf, Gs, Aa, Aa, Gs, Aa, Gs, Hh^Fp, Hh^Fp, Hh^Fp, Hh^Fp, Ha^Fma, Ai, Ai
Ha^Fda, Aa, Rd, Dd, Dd, Ss, Ww, Wwr, Wwr, Ww, Ww, Wo, Wo, Wot, Wot, Wot, Wot, Wwt, Wwt, Wwt, Wwt, Wwrt, Wwrt, Wwf, Ss, Gs, Gs, Gs, Hh, Gs, Gs^Fp, Gs, Gs, Aa, Ha^Fpa, Ha^Fma, Ai, Ha^Fma
Aa, Aa, Rd, Dd, Ss, Ss, Ww, Wwr, Wwr, Wwr, Ww, Wo, Wo, Wo, Wot, Wot, Wot, Wot, Wot, Wwt, Wwt, Wwrt, Wwf, Wwf, Gs, Gs, Gs, Hh, Ha^Fma, Hh, Ha^Fma, Gs^Fp, Gs, Aa, Ha^Fpa, Ha^Fpa, Ai, Ai
Aa, Rd, Dd^Es, Dd, Ss, Ww, Ww, Ww, Ww, Ww, Ww, Ww, Wo, Wo, Wo, Wot, Wot, Wot, Wot, Wwt, Wwt, Ww, Wwf, Gs, Aa, Aa, Gs, Hh, Ha^Fma, Ha^Fma, Ha^Fma, Gs^Fp, Gs^Vht, Gs, Hh^Fp, Aa, Ai, Ha^Fpa
Ha, Aa, Dd^Es, Ss, Ss, Ss, Ww, Ww, Ww, Ww, Dd, Ww, Ww, Ww, Wo, Wot, Wot, Wot, Wwt, Wwt, Ww, Ww, Gs, Gs, Aa, Gs^Vhs, Hh^Fp, Hh, Ha^Fma, Ha^Fma, Gs^Fp, Gs^Fp, Gs, Gs, Gs, Aa, Ai, Ha^Fpa
Aa, Aa, Dd, Dd^Es, Ss, Ww, Wwr, Ww, Ww, Dd, Dd^Es, Ww, Dd, Ww, Ww, Wot, Wot, Wot, Wot, Wwt, Ww, Ww, Gs, Aa, Aa, Gs, Hh^Fp, Ha^Fma, Hh, Hh, Gs, Gs, Wwt, Wwt, Wwt, Wwt, Wwt, Ai^Es
Aa, Rd, Dd, Ss, Ss, Ww, Wwr, Wwr, Ww, Dd, Dd^Es, Dd^Es, Dd^Es, Dd, Ww, Wot, Wot, Wot, Wot, Ww, Ww, Ww, Ss, Gs, Gs, Gs, Gs, Hh^Fp, Gs, Gs, Gs, Ss, Wwt, Ss, Gs, Ss, Wwt, Aa
Dd, Rd, Rd, Dd, Ss, Ww, Ww, Wwr, Ww, Ww, Dd^Es, Dd^Vdt, Dd^Es, Dd, Ww, Wo, Wot, Wot, Wo, Wo, Ww, Ww, Ww, Ss, Gs, Hh, Gs, Gs, Gs, Ha^Fpa, Hh^Fp, Ss, Wwt, Wwt, Ss, Ha^Fma, Wwt, Aa
Dd, Dd^Es, Dd, Csz^Ksy, Chw, Wwr, Ww, Ww, Ww, Dd, Dd, Dd^Dr, Dd, Ww, Wo, Wo, Wot, Wot, Wo, Wo, Ww, Ww, Ss^Bw/, Gs, Gs, Gs, Cwz, Ce, Ce, Hh^Fp, Ss, Ss, Wwt, Ss, Hh^Fp, Ha^Fma, Wwt, Ha^Fma
Dd, Dd, Ss, Chw, Wwr, Wwr, Ww, Wo, Wo, Ww, Dd, Dd, Ww, Ww, Wo, Wo, Wot, Wot, Wo, Wo, Ww, Ww^Vht, Ww, Ss, Chw, Cwz, Ss, 1 Ke, Cwz, Ce, Ss, Wwt, Hh^Fp, Ss, Hh^Fp, Wwt, Ha^Fpa, Ha^Fpa
Dd, Ss^Vhs, Ss, Ww, Wwr, Wwr, Ww, Wo, Wo, Ww, Ww, Ww, Wo, Wo, Wot, Wot, Wo, Wo, Wo, Ww, Ww, Ww, Ww, Ww, Ww, Ss, Ww, Ss, Ww, Ss, Ww, Hh^Fp, Ha^Fpa, Ha^Fpa, Hh^Fp, Wwt, Hh^Fp, Ha^Fpa
Ss, Ss, Ww, Ww, Ww, Ww, Wo, Wo, Wo^Vm, Wo, Wo, Wo, Wot, Wot, Wot, Wo, Wo, Wo, Ww, Ww, Ww, Ss, Ss, Ss, Gs, Ww, Ss, Ww, Ss, Ww, Ss, Hh^Fp, Ss, Hh^Fp, Wwt, Wwt, Hh^Fp, Ha^Fpa
Ss, Ww, Ww, Ww, Ww, Ww, Wo, Wo, Wo, Wo, Wot, Wot, Wot, Wot, Wo, Wo, Wo, Wo, Ww, Ww, Gs^Es, Gs^Es, Gs, Ss, Gs, Hh, Ha^Fpa, Hh, Ss, Ww, Ss^Vhs, Ss, Hh^Fp, Hh^Fp, Wwt, Hh^Fp, Ha^Fpa, Ha^Fpa
Ww, Ww, Ww, Ww, Ww, Wo, Wo, Wo, Wot, Wot, Wot, Wot, Wo, Wo, Wo, Wo, Wo, Wo, Ww, Ww, Ss, Gs^Es, Gs, Gs, Gs, Aa, Gs, Gs, Ss, Ww, Ww, Ww, Wwt, Wwt, Hh^Fp, Hh^Fp, Ms, Ms
Ww, Ww, Ww, Ww, Wo, Wo, Wo, Wo, Wot, Wot, Wot, Wo, Wo, Wo, Ww, Ww^Vm, Wo, Wo, Ww, Gs, Gs, Ss, Ss, Ss, Ss, Gs, Ss, Ss, Ww, Ww, Ss, Hh^Fp, Ha^Fpa, Hh^Fp, Ha^Fpa, Ha^Fpa, Ms, Ms
Ww, Ww, Wo, Wo, Wo, Wo, Wo, Wot, Wot, Wot, Wo, Wo, Wo, Wo, Ww, Ww, Wo, Ww, Gs, Gs, Ss, Ss, Ww, Ww, Ww, Ss, Ww, Ww, Gs, Ww, Wwt, Aa, Aa, Aa, Ai, Ha^Fma, Ms, Ms
Wo, Wo, Wot, Wot^Vm, Wot, Wot, Wot, Wot, Wot, Wot, Wo, Wo, Wo, Wo, Wo, Wo, Ww, Ww, Ss, Gs, Ss, Ww, Ww, Ss^Vhs, Ss, Ww, Gs, Gs, Aa, Aa, Ai, Ai, Ai, Ai, Ha^Fma, Ha^Fma, Ms, Ms
Wwt, Wot, Wot, Wot, Wot, Wot, Wot, Wot, Wot, Wot, Wwt, Wo, Wo, Wo, Wo, Wo, Wo, Ww, Ww, Ww, Ww, Ww, Ss, Ss, Gs, Ss, Gs, Gs, Gs, Aa, Aa, Aa, Ai, Ha^Fma, Ha^Fma, Ms, Ms, Ms
