border_size=1
usage=map

Hh^Ftp, Hh^Ftp, Dd, Dd, Dd, Dd, Wwt, Wwt, Wwt, Dd, Wwt, Dd, Dd, Dd, Wwt, Wwt, Wwt, Wwt, Wwt, Wot, Wot, Wot, Wot, Wot, Wwt, Wwt, Wwt, Wwt, Wwt, Wwt, Ai, Ai, Aa, Ai, Aa, Aa, Ha^Fpa, Ha^Fpa
Hh^Ftp, Hh^Ftp, Dd, Dd, Dd, Wwt, Wwt, Wwt, Dd, Dd, Dd, Wwt, Dd, Dd, Dd, Wwt, Ww^Vm, Wwt, Wwt, Wwt, Wot, Wot, Wot, Wot, Wwt, Wwt, Wwt, Wwt, Wwt, Ai, Ai, Ai, Ha, Aa, Ha, Aa, Ha^Fpa, Ha^Fpa
Hh^Ftp, Dd, Dd, Dd, Wwt, Wwt, Wwrt, Wwrt, Wwt, Dd, Wwrt, Wwrt, Wwrt, Wwt, Wwt, Wwt, Wwt, Wwt, Wwt, Wot, Wot, Wot, Wot, Wwt, Wwt, Wwt, Wwt, Wwt, Gs, Gs, Hh, Ai, Ha^Fma, Ha, Mm, Ha, Mm, Ha^Fpa
Dd, Dd, Dd, Dd, Wwt, Wwt, Wwrt, Wwt, Chw, Wwrt, Wwrt, Wwrt, Wwt, Wwrt, Wwrt, Wwrt, Wwrt, Wwrt, Wwrt, Chw, Wot, Wot, Wot, Wwt, Wwt, Wwt, Wwt, Wwt, Gs, Gs^Vhs, Gs, Ha, Mm, Mm, Mm, Hh^Fp, Mm, Mm
Rd, Dd, Dd, Wwt, Wwt, Wwrt, Chw, Wwt, 2 Khw, Chw, Wwrt, Wwt, Ww^Vm, Wwt, Wwrt, Wwrt, Wwrt, Wwrt, Wwt, Chw, Wot, Wot, Wot, Wot, Wwt, Wwt, Gs, Gs, Hh, Hh, Ha, Ha^Fma, Mm, Mm, Mm, Ha^Fma, Mm, Mm
Aa, Rd, Dd, Wwt, Wwrt, Wwrt, Ww^Ewl, Chw, Chw, Chw, Wwt, Wwt, Wwt, Wwt, Wwrt, Wwt, Wwrt, Wwt, Wwrt, Wwrt, Wot, Wot, Wot, Wwt, Wwt, Wwt, Wwt, Gs, Hh, Hh, Md, Mm, Mv, Mm, Mm, Ha^Fma, Mm, Ha^Fma
Aa, Rd, Dd, Wwt, Wwt, Wwrt, Wwt, Ww^Ewl, Wwt, Wwt, Wwrt, Wwrt, Wwrt, Wwrt, Wwrt, Wwrt, Wwt, Wwrt, Wot, Wot, Wot, Wot, Wot, Wot, Wwt, Wwt, Ww, Gs, Ww, Hh, Hh, Md, Md, Mm, Mm, Hh^Fp, Mm, Ha^Fma
Aa, Rd, Rd, Dd, Ss, Wwt, Ww^Vm, Wwt, Wwt, Wwt, Wwrt, Wwrt, Wwt, Wwt, Wwrt, Wwt, Wot, Wwt, Wot, Wot, Wot, Wwt, Wwt, Wwt, Wwt, Wwt, Wwt, Ww, Gs, Ww, Hh, Mm, Mm, Mm, Mm, Mm, Ms^Vaa, Ms
Ha^Fda, Aa, Rd, Dd, Dd^Es, Ss, Ss, Wwt, Wwt, Wwrt, Wwrt, Wwrt, Wwt, Wwrt, Wwrt, Wwt, Wot, Wot, Wot, Wot, Wwt, Wwt, Wwt, Wwrt, Wwrt, Wwt, Gs, Hh, Hh, Hh, Md, Mm, Mm, Mm, Mm, Ms, Ms, Ms
Ha^Fpa, Aa, Aa, Dd^Es, Dd, Dd, Ss, Wwt, Wwt, Wwt, Wwt, Wwt, Wwt, Wwt, Wwt, Wwt, Wot, Wot, Wot, Wwt, Wwt, Wwt, Wwrt, Wwrt, Wwt, Ss, Gs, Hh, Hh^Vht, Hh, Mm, Md, Md, Mm, Mm, Mm, Mm, Ms
Ms, Ha^Fda, Aa, Rd, Dd, Ss, Wwt, Wwt, Wwt, Wwt, Wot, Wwt, Wot, Wwt, Wwt, Wot, Wot, Wot, Wwt, Wwt, Wwrt, Wwt, Wwrt, Wwrt, Wwt, Gs, Gs, Hh, Hh, Hh, Hh^Fp, Mm, Mm, Mm, Mm, Mm, Ha^Fpa, Ha^Fpa
Ms, Ha^Fda, Aa, Rd, Dd, Ss, Ss, Wwt, Wwt, Wwt, Wwt, Wot, Wot, Wot, Wot, Wot, Wot, Wot, Wwt, Wwrt, Wwrt, Wwrt, Wwrt, Wwrt, Ss, Gs, Aa, Gs, Gs, Gs, Gs, Hh^Fp, Mm, Mm, Hh^Fp, Hh^Fp, Ha^Fma, Ha^Fpa
Ha^Fda, Ha^Vaa, Aa, Dd, Ss, Ss, Wwt, Wwt, Wwrt, Wwt, Wwt, Wot, Wot, Wot, Wot, Wot, Wot, Wwt, Wwt^Vm, Wwt, Wwrt, Wwrt, Wwrt, Wwf, Wwf, Gs, Aa, Aa, Gs, Aa, Gs, Hh^Fp, Hh^Fp, Hh^Fp, Hh^Fp, Ha^Fma, Ai, Ai
Ha^Fda, Aa, Rd, Dd, Dd, Ss, Wwt, Wwrt, Wwrt, Wwt, Wwt, Wwt, Wot, Wot, Wot, Wot, Wot, Wwt, Wwt, Wwt, Wwt, Wwrt, Wwrt, Wwf, Ss, Gs, Gs, Gs, Hh, Gs, Gs^Fp, Gs, Gs, Aa, Ha^Fpa, Ha^Fma, Ai, Ha^Fma
Aa, Aa, Rd, Dd, Ss, Ss, Wwt, Wwrt, Wwrt, Wwrt, Wwt, Wot, Wot, Wot, Wot, Wot, Wot, Wot, Wot, Wwt, Wwt, Wwrt, Wwf, Wwf, Gs, Gs, Gs, Hh, Ha^Fma, Hh, Ha^Fma, Gs^Fp, Gs, Aa, Ha^Fpa, Ha^Fpa, Ai, Ai
Aa, Rd, Dd^Es, Dd, Ss, Wwt, Wwt, Wwt, Wwt, Wwt, Wwt, Wwt, Wot, Wot, Wot, Wot, Wot, Wot, Wot, Wwt, Wwt, Wwt, Wwf, Gs, Aa, Aa, Gs, Hh, Ha^Fma, Ha^Fma, Ha^Fma, Gs^Fp, Gs^Vht, Gs, Hh^Fp, Aa, Ai, Ha^Fpa
Ha, Aa, Dd^Es, Ss, Ss, Ss, Wwt, Wwt, Wwt, Wwt, Dd, Wwt, Wwt, Wwt, Wot, Wot, Wot, Wot, Wwt, Wwt, Wwt, Wwt, Gs, Gs, Aa, Gs, Hh^Fp, Hh, Ha^Fma, Ha^Fma, Gs^Fp, Gs^Fp, Gs, Gs, Gs, Aa, Ai, Ha^Fpa
Aa, Aa, Dd, Dd^Es, Ss, Wwt, Wwrt, Wwt, Wwt, Dd, Dd^Es, Wwt, Dd, Wwt, Wwt, Wot, Wot, Wot, Wot, Wwt, Wwt, Wwt, Gs, Aa, Aa, Gs, Hh^Fp, Ha^Fma, Hh, Hh, Gs, Gs, Wwt, Wwt, Wwt, Wwt, Wwt, Ai
Aa, Rd, Dd, Ss, Ss, Wwt, Wwrt, Wwrt, Wwt, Dd, Dd, Dd, Dd^Es, Dd, Wwt, Wot, Wot, Wot, Wot, Wwt, Wwt, Wwt, Gs, Gs, Gs, Gs, Gs, Hh^Fp, Gs, Gs, Gs, Ss, Wwt, Ss, Gs, Ss, Wwt, Aa
Dd, Rd, Rd, Dd, Ss, Wwt, Wwt, Wwrt, Wwt, Wwt, Dd, Dd^Vdt, Dd, Dd, Wwt, Wot, Wot, Wot, Wwt, Wwt, Wwt, Gs, Ss, Gs, Gs, Gs, Gs, Gs, Gs, Ha^Fpa, Hh^Fp, Ss, Wwt, Wwt, Ss, Ha^Fma, Wwt, Aa
Dd, Dd^Es, Dd, Csz^Ksy, Chw, Wwrt, Wwt, Wwt, Wwt, Wwt, Wwt, Dd, Wwt, Wwt, Wot, Wot, Wot, Wot, Wot, Wwt, Wwt, Ss, Ss^Bw/, Gs, Ss, Gs, Cwz, Ce, Ce, Hh^Fp, Ss, Ss, Wwt, Ss, Hh^Fp, Ha^Fma, Wwt, Ha^Fma
Dd, Dd, Ss, Chw, Wwrt, Wwrt, Wwt, Wot^Vm, Wot, Wot, Wwt, Wwt, Wot, Wwt, Wot, Wot, Wot, Wot, Wot, Wwt, Wwt, Wwt^Vht, Wwt, Ss, Wwt, Chw, Ss, 1 Ke, Cwz, Ce, Ss, Wwt, Hh^Fp, Ss, Hh^Fp, Wwt, Ha^Fpa, Ha^Fpa
Dd, Ss, Ss, Wwt, Wwrt, Wwrt, Wwt, Wwt, Wot, Wot, Wot, Wot, Wot, Wot, Wot, Wot, Wot, Wot, Wot, Wwt, Wwt, Wwt, Wwt, Wwt, Wwt, Wwt, Wwt, Ss, Wwt, Ss, Wwt, Hh^Fp, Ha^Fpa, Ha^Fpa, Hh^Fp, Wwt, Hh^Fp, Ha^Fpa
Ss, Ss, Wwt, Wwt, Wwt, Wwt, Wot, Wot, Wot, Wot, Wot, Wot, Wot, Wot, Wot, Wot, Wot, Wot, Wwt, Wwt, Wwt, Ss, Ss, Ss, Gs, Wwt, Ss, Wwt, Ss, Wwt, Ss, Hh^Fp, Ss, Hh^Fp, Wwt, Wwt, Hh^Fp, Ha^Fpa
Ss, Wwt, Wwt, Wwt, Wwt, Wwt, Wot, Wot, Wot, Wot, Wot, Wot, Wwt, Wot, Wot, Wot, Wot, Wwt, Wwt, Wwt, Gs^Es, Gs^Es, Gs, Ss, Gs, Hh, Ha^Fpa, Hh, Ss, Wwt, Ss^Vhs, Ss, Hh^Fp, Hh^Fp, Wwt, Hh^Fp, Ha^Fpa, Ha^Fpa
Wwt, Wwt, Wwt, Wwt, Wwt, Wot, Wot, Wot, Wot, Wot, Wot, Wwt, Dd, Wwt, Wwt, Wwt, Wwt, Wwt, Wwt, Wwt, Ss, Gs^Es, Gs, Gs, Gs, Aa, Gs, Gs, Ss, Wwt, Wwt, Wwt, Wwt, Wwt, Hh^Fp, Hh^Fp, Ms, Ms
Wwt, Wwt, Wwt, Wwt, Wot, Wot, Wot, Wot, Wot, Wot, Wwt, Wwt, Ww^Vm, Dd^Es, Dd, Wwt, Wwt, Wwt, Wwt, Gs, Gs, Ss, Ss, Ss, Ss, Gs, Ss, Ss, Wwt, Wwt, Ss, Hh^Fp, Ha^Fpa, Hh^Fp, Ha^Fpa, Ha^Fpa, Ms, Ms
Wwt, Wwt, Wot, Wot, Wot, Wot, Wot, Wot, Wot, Wot, Wwt, Dd, Dd, Dd^Es, Wwt, Wwt, Wwt, Wwt, Gs, Gs, Ss, Ss, Wwt, Wwt, Wwt, Ss, Wwt, Wwt, Gs, Wwt, Wwt, Aa, Aa, Aa, Ai, Ha^Fma, Ms, Ms
Wot, Wot, Wot, Wot^Vm, Wot, Wot, Wot, Wot, Wot, Wot, Wwt, Wwt, Wwt, Wwt, Wwt, Wwt, Wwt, Wwt, Ss, Gs, Ss, Wwt, Wwt, Ss^Vhs, Ss, Wwt, Gs, Gs, Aa, Aa, Ai, Ai, Ai, Ai, Ha^Fma, Ha^Fma, Ms, Ms
Wwt, Wot, Wot, Wot, Wot, Wot, Wot, Wot, Wot, Wot, Wwt, Wwt, Wwt, Wwt, Wwt, Wwt, Wwt, Wwt, Wwt, Wwt, Wwt, Wwt, Ss, Ss, Gs, Ss, Gs, Gs, Gs, Aa, Aa, Aa, Ai, Ha^Fma, Ha^Fma, Ms, Ms, Ms
