border_size=1
usage=map

Ms, Ms, Ms, Ms, Ms, Ms, Ms, Ha^Fpa, Aa, Ha^Fpa, Ha^Fpa, Ms, Ha^Fpa, Ms, Ms, Ha^Fpa, Ha^Fma, Aa, Ai, Wwt, Aa, Aa, Aa, Ai, Ha^Fma, Ha^Fda, Ha^Fda, Ms, Ha^Fda, Ms, Ms, Ms, Ha^Fda, Ha^Fda, Aa, Dd, Rd, Rd
Ms, Ms, Ha^Fpa, Ha^Fpa, Ha^Fpa, Ha^Fpa, Ha^Fpa, Ha^Fpa, Ai, Aa, Aa, Ha^Fpa, Aa, Ha^Fpa, Ha^Fpa, Ha^Fma, Aa, Aa^Voa, Ai, Wwt, Wwt, Ai, Ai, Ai, Aa, Aa, Aa, Ha^Fda, Aa, Ha^Fda, Ha^Fda, Ha^Fda, Aa, Aa, Aa, Rd, Dd^Es, Dd^Es
Ms, Ms, Ms, Ms, Ms, Ms, Ha^Fpa, Ai, Ww, Ai, Ai, Aa, Ai, Aa, Aa, Aa, Aa, Ai, Ww, Ww, Aa, Aa, Aa, Ai, Ai, Aa^Voa, Aa, Aa, Aa, Aa, Aa, Aa, Csz, Csz, Csz, Rd, Aa, Aa
Mm, Ms, Ms, Ms^Vaa, Ha^Fpa, Ha^Fpa, Ai, Ai, Gs^Ft, Ai, Ss, Ai, Ss, Ai, Ai, Ai, Ai, Ai, Ss, Ss, Aa, Aa, Ai, Ai, Aa, Aa, Ha, Aa, Hd, Dd, Rd, Aa, Csz, 1 Csz^Ksy, Csz, Dd, Aa, Ha^Fda
Mm, Mm, Ms, Ha^Fpa, Ha^Fpa, Ha^Fpa, Ai, Aa, Aa, Gs^Ft, Gs^Ft, Ss, Gs^Ft, Ss, Ss, Ss, Gs^Ft, Ss, Cea, Cwz, Cwz, Ai, Ss, Ai, Dd^Rby, Ha, Rd, Hd^Fetd, Rd, Rd, Dd^Es, Dd, Aa, Csz, Dd^Es, Dd, Aa, Ha^Fda
Mm, Mm, Ms, Ha^Fpa, Ha^Fpa, Ai, Aa, Aa, Hd^Ftd, Gs^Ft, Gs^Ft, Gs^Ft, Gs^Ft, Ss, Gs^Ft, Gs^Ft, Ha^Fda, Gs^Ft, Ce, 2 Kea, Ce, Aa, Dd^Es, Ss, Ss^Bw/, Rd, Dd, Rd, Aa, Dd^Es, Dd, Aa, Rd, Aa, Dd^Es, Dd^Es, Dd^Vo, Aa
Ms, Ms, Ms, Ha^Fpa, Cea, Ai, Aa, Dd^Es, Dd^Es, Hd^Ftd, Aa, Aa^Voa, Aa, Gs^Ft, Aa, Ha^Fda, Hd, Hd, Dd^Es, Ce, Rd, Aa, Rd, Rd, Dd^Ftd, Ss, Ss, Aa, Ai, Aa, Dd, Rd, Dd, Dd, Dd, Dd^Es, Dd, Aa
Ms, Ms, Ha^Fpa, Ha^Fpa, Ai, Aa, Aa, Aa, Aa, Aa, Aa, Aa, Aa, Aa, Dd^Es, Ha^Fetd, Dd^Es, Dd^Es, Rd, Rd, Dd^Es, Rd, Ha, Ha, Ce, Ss, Gs^Ft, Ss, Ai, Aa, Ss, Rd, Ss, Dd^Ftd, Gs^Ft, Dd, Aa, Aa
Ms, Mm, Hh^Fp, Ha^Fpa, Ai, Aa, Gs^Ft, Gs^Ft, Dd^Es, Aa, Dd, Gs^Ft, Gs^Ft, Aa, Ha, Dd^Es, Dd^Es, Rd, Dd^Es, Dd^Es, Hd, Dd^Es, Dd^Es, Cea, 4 Ke, Gs^Ft, Gs^Ft, Ss, Ss, Ss, Ss, Ss^Bw|, Aa, Ss, Ss, Gs^Ft, Aa, Ha^Fpa
Ms, Mm, Hh^Fp, Ha^Fpa, Ai, Aa, Gs^Ft, Dd^Rby, Dd^Es, Aa, Dd^Es, Dd^Es, Aa, Aa, Ha, Ha, Rd, Rd, Aa, Aa, Aa, Hd, Aa, Cea, Cea, Ce, Dd^Ftd, Gs^Ft, Ss, Ss, Ai, Aa, Aa, Ww, Ww, Aa, Aa, Ha
Ms, Hh^Fp, Ha^Vaa, Ha^Fpa, Ai, Aa, Hh^Fp, Gs^Ft, Dd^Es, Dd^Es, Aa, Dd^Es, Dd^Es, Dd^Es, Aa, Rd, Dd^Es, Dd^Dr, Dd, Aa^Voa, Aa, Ha^Fetd, Ha^Fma, Aa, Dd^Es, Dd^Es, Dd^Ftd, Gs^Ft, Ss, Ww, Ai, Aa, Aa^Vaa, Aa, Wwt, Ai, Ai, Aa
Ms, Ha^Fpa, Ha^Fpa, Ai, Ai, Ai, Cwz, Ce, Cwz, Ai, Ss, Aa, Aa, Dd^Es, Rd, Rd, Hd, Dd^Es, Dd^Es, Aa, Aa, Ha^Fma, Aa, Aa, Aa, Aa, Ai, Ss, Ss, Ai, Aa, Aa, Aa, Aa, Ai, Aa, Ai, Aa
Ms, Ms, Ms, Ha^Fpa, Mm, Ss, Cwz, 6 Cwz^Ksy, Coa, Ss, Ss, Aa, Dd^Es, Dd^Es, Rd, Ha, Ha, Hd, Dd^Es, Dd, Aa, Aa, Ai, Ai, Ai, Ai, Ww, Ww, Ai, Aa, Aa, Rd, Aa, Ai, Ai, Aa, Ss, Ai
Ms, Ms, Ms, Ms, Ss, Ss, Mm, Cea, Ha^Fpa, Ha^Fpa, Ss, Dd, Dd^Es, Aa, Rd, Dd^Es, Ha^Fda, Dd^Es, Dd^Es, Aa, Aa, Aa, Ai, Ss, Ss, Ww, Ss, Ai, Aa, Aa, Aa, Rd, Dd, Aa, Ai, Ss, Ss, Ai
Ms, Ms, Ha^Fpa, Ha^Fma, Ss, Mm, Ms, Ha^Fpa, Ai, Ss, Ha^Fpa, Ss, Ai, Aa, Aa, Dd^Es, Hd, Gs^Ft, Ce, Dd, Dd^Es, Dd^Rby, Gs^Ft, Gs^Ft, Ss, Ss, Aa, Aa, Aa, Dd, Rd, Dd^Es, Ha, Aa, Ai, Ww, Ss, Aa
Ha^Fpa, Ha^Fpa, Ai, Ss, Mm, Mm, Ms, Ha^Fpa, Ai, Ms, Ha^Fpa, Ss, Wo, Ai, Aa, Hd^Fetd, Hd^Ftd, Gs^Ft, Gs^Ft, Ss, Ss, Dd^Ftd, Ss, Ss, Gs^Ft, Gs^Ft, Dd, Dd^Vdt, Aa, Rd, Dd^Es, Ha, Ha, Aa, Aa, Ai, Ss, Aa
Ha^Fpa, Ai, Ai, Hh^Fp, Cha, Ms, Ha^Fpa, Ha^Fma, Ss, Ha^Fpa, Ss, Ss, Ww, Ai, Aa^Vaa, Aa, Gs^Ft, Gs^Ft, Aa^Ft, Ss, Wo, Ss, Ww, Ww, Gs^Ft, Dd^Ftd, Hd, Dd^Es, Dd^Es, Rd, Dd^Dr, Dd^Es, Ha, Aa, Ai, Ai, Ss, Ss
Ms, Ha^Fpa, Ha^Fpa, Ai, Hh^Fp, Ha^Fpa, Ai, Ss, Ai, Ss, Aa, Ai, Ww^Bw/, Aa, Ai, Aa, Aa, Ss, Ss, Ss, Ai, Ww, Ss, Gs^Ft, Gs^Ft, Dd^Ftd, Ha, Hd^Fetd, Dd, Rd, Rd, Dd^Es, Aa, Aa, Ai, Ss, Ww, Ww
Ms, Ms, Ha^Vaa, Ai, Ai, Hh^Fp, Ss, Ss, Ai, Aa, Aa, Aa, Ai, Ww, Wo, Ss, Ss, Ss, Wo, Ai, Aa, Ai, Aa, Gs^Ft, Aa, Aa, Dd^Es, Dd, Aa, Dd, Aa, Rd, Rd, Aa, Ss, Ss, Ww, Ai
Ha^Fpa, Ms, Ms, Ha^Fpa, Ha^Fpa, Ai, Hh^Fp, Hh^Fp, Aa, Ha^Fpa, Ha^Fpa, Aa, Aa, Ss, Ai, Ss, Ai, Ss, Ai, Ai, Ss, Aa, Aa, Aa, Aa, Aa, Dd, Dd^Es, Dd, Aa, Aa, Aa, Ai, Ss^Bw\, Rd, Aa, Ai, Ai
Ha^Fpa, Mm, Ha^Fpa, Ms, Ha^Fpa, Ha^Fpa, Aa, Aa, Ms, Mm, Mm, Ha^Fpa, Aa, Ai, Aa, Aa, Aa, Ss, Ss, Ss, Aa^Vaa, Ss, Ss, Ss, Ss, Ai, Cea, Ce, Cea, Aa, Ai, Ai, Ss, Ss, Dd, Aa, Aa, Ha^Fma
Ms, Hh^Fp, Ha^Fpa, Ms, Ha^Fpa, Aa, Ms, Ms, Ms, Ms, Ms, Ha^Fpa, Ha, Aa, Hh^Fp, Hh^Fp, Hh, Hh^Fp, Ss, Aa, Ai, Aa, Aa, Aa, Ss, Ss, Cwz, 5 Cwz^Ksy, Cwz, Ai, Ss, Ss, Ai, Ai, Cea, Dd, Rd, Aa
Ms, Ms, Ms, Ha^Fpa, Ha^Fpa, Aa, Ha^Fpa, Ms, Cha, Coa, Coa, Ha, Ha^Fpa, Aa, Hh^Fp, Mm, Mm, Hh, Hh, Ss, Ss, Ha^Fpa, Ha, Aa, Ww, Ww, Aa, Cea, Ha^Fpa, Ai, Ww, Ss, Ai, Aa, Aa, Dd^Es, Dd^Vdt, Rd
Ms, Ms, Ms, Ms, Ha, Aa, Ha^Fpa, Ms, Cha, 3 Kha, Coa, Ms, Hh^Fp, Hh^Fp, Ss, Ss, Ss, Hh^Fp, Ss, Ss^Bw\, Ha, Ha, Hh^Fp, Aa, Wwt, Aa, Ha^Fpa, Ha^Fpa, Ha^Fpa, Aa, Ai, Ww, Ww, Ai, Ss, Aa, Aa, Aa
Ms, Ms, Ms, Ha^Fpa, Aa, Aa, Ha^Fpa, Ha, Ms, Cha, Ms, Hh^Fp, Ss, Ss, Hh^Fp, Ss, Hh^Fp, Ss, Ss, Ha^Fpa, Ms, Mm, Mm, Hh^Fp, Wwt, Aa, Ha^Fpa, Ms, Ms, Ha^Fpa, Ha^Fpa, Ss, Ss, Ww, Ww, Ss, Ai, Ha^Fma
Ha^Fpa, Ha^Fpa, Ms, Ha^Fpa, Ha^Fpa, Hh, Ha, Ms, Ms, Ms, Ai, Ss, Hh^Fp, Hh^Fp, Ms, Ha^Vaa, Ha^Fpa, Ha^Fpa, Ww, Ha^Fpa, Ms, Cha, Ms, Wwt, Ha^Fpa, Ha^Fpa, Ms, Ms^Xm, Ms^Xm, Ms, Ha^Fpa, Ai, Ai, Ss, Ai, Ww, Wwt, Ai
Hh^Fp, Hh^Fp, Ms, Ha^Vaa, Ha^Fpa, Hh, Ha, Ms, Ha^Fpa, Ha^Fpa, Ww, Ss, Ww, Ms, Ms, Ms, Ms, Wwt, Ha^Fpa, Ha^Fpa, Ms, Ms, Ai, Wo, Ha^Fpa, Ms, Ms, Ms, Ha^Fpa, Ms, Ha^Fpa, Ha^Fpa, Aa, Ai, Aa, Ai, Wwt, Wwt
Ha^Fpa, Hh^Fp, Ms, Ms, Ms, Ha, Ms, Ha, Ai, Ai, Hh^Fp, Ww, Hh^Fp, Ai, Ai, Ai, Wwt, Wwt, Wwt, Ms, Wwt, Ha^Fpa, Wwt, Wo, Wo, Ha^Fpa, Ai, Ha^Fpa, Ai, Ha^Fpa, Ss, Aa, Ai, Aa, Aa, Ai, Ai, Wwt
Ms, Ms, Ms, Ms, Ms, Ms, Ai, Ai, Ms, Mm, Mm, Hh^Fp, Mm, Mm, Ms, Ai, Ms, Ha^Fpa, Ha^Fpa, Wwt, Ha^Fpa, Wwt, Ha^Fpa, Ha^Fpa, Ha^Fpa, Wo, Wo, Wo, Wo, Wo, Ww, Ai, Ai, Aa, Aa, Aa, Ai, Wwt
Ms, Ms, Ms, Ms, Ms, Ha^Fpa, Ai, Ha^Fpa, Ms, Ms, Ms, Mm, Ms, Ms, Ai, Ai, Ms, Ms, Ms, Ms, Ms, Ha^Fpa, Ms, Ms, Ha^Fpa, Ai, Ai, Wwt, Ai, Ww, Ss, Ww, Aa, Aa^Vaa, Aa, Aa, Ai, Wwt
Ms, Ms, Ms, Ms, Ai, Ai, Ha^Fpa, Ha^Fpa, Ms, Ms, Ms^Vaa, Ms, Ms, Ai, Ms, Ms, Ms, Ha^Fpa, Ha^Fpa, Ha^Fpa, Ha^Fpa, Ms, Ha^Fpa, Ms, Ha^Fpa, Ha^Fpa, Aa, Ai, Aa, Ai, Aa, Ss, Ai, Aa, Ss, Ss, Ss, Ww
Ms, Ms, Ms, Ha^Fpa, Ai, Ha^Fpa, Ms, Ms, Mm, Ms, Ms, Ms, Ai, Ai, Ms, Ms^Xm, Ms, Ha^Fpa, Aa^Fetd, Aa, Ha^Fpa, Ha^Fpa, Ms, Ha^Fpa, Aa, Aa, Aa, Aa, Ha^Fpa, Aa, Aa, Ss^Bw/r, Ss, Ss, Ai, Ai, Ai, Ai
Ms, Ms, Ha^Fpa, Ha^Fpa, Ai, Ha^Fpa, Ms, Mm, Ms, Ms, Ha^Fpa, Ha^Fpa, Ai, Ha^Fpa, Ms, Ms^Xm, Ms, Ha^Fpa, Aa, Aa, Ha^Fetd, Ms, Ha^Fpa, Ha^Fpa, Hh^Fp, Gs^Es, Aa, Ha^Fma, Ms, Ha^Fpa, Ha^Fpa, Aa, Ww, Ss, Ai, Ha^Fpa, Ha^Fpa, Ha^Fpa
Ms, Ms, Ha^Fpa, Ai, Ha^Fpa, Ha^Fpa, Ms, Mm, Mm, Ms, Ha^Fpa, Ai, Ha^Fpa, Ms, Ms, Ms, Ha^Fpa, Ha^Fpa, Aa, Ha^Fpa, Ms, Ha^Fpa, Mm, Hh^Fp, Gs, Gs^Es, Aa, Ha^Fma, Ms, Ms, Ha^Fpa, Ai, Wwt, Ai, Ha^Fpa, Ha^Fpa, Ms, Ms
