border_size=1
usage=map

Ds, Aa, Xu, Xu, Xu, Xuc, Xu, Xuc, Xu, Xu, Xu, Xu, Xu, Uh, Uu, Uu^Br|, Urb, Urb, Uu, Xuc, Uu, Uu, Urb, Urb, Urb, Urb, Urb, Urb, Urb, Urb, Urb, Urb, Uu, Uu, Xuc, Xuc, Ss, Wwg, Wo, Wo, Wwg, Ss, Ss, Ss, Hhd, Hhd, Hhd, Ha, Ha, Ms, Ms, Ms
Aa, Aa, Xu, Xu, Xu, Xu, Xu, Xu, Uu, Xu, Uh, Xuc, Xuc, Uh, Uu, Uu^Br|, Urb, Urb, Uu^Vu, Xuc, Uu, Urb, Urb, Urb, Uu, Uu, Uu, Uu, Uu, Uu, Uu, Uu^Vo, Xuc, Xuc, Xuc, Ss, Wwg, Wwg, Wo, 5 Wo, Wwg, Ss, Ss, Hhd, Mm, Mv, Mm, Hhd, Hhd, Ha, Ha, Ms
Cud, Uh, Xuc, Xu, Xuc, Uu^Vu, Uu, Uu, Urb, Uu, Uu, Cud, 4 Kud, Xu, Uu, Uu^Br|, Urb, Urb, Urb, Uu^Uf, Urb, Urb, Urb, Urb, Uu, Uu^Uf, Xuc, Xuc, Xuc, Xuc, Xuc, Xuc, Ss, Ss, Ss, Ss, Wwg, Wo, Wwg, Wwg, Ss, Ss, Ss, Hhd, Hhd, Mm, Mm, Mv, Mm, Hhd, Ha, Ms
Uu, Uu, Uu, Xuc, Uu, Uu, Urb, Urb, Urb, Urb, Urb, Cud, Cud, Cud, Urb, Urb^Br|, Urb, Urb, Urb, Urb, Urb, Urb, Sm, Sm, Ss, Ss, Ss, Ss, Ss, Ss, Ss, Ss, Wwg, Wwg, Wwg, Wwg, Wo, Wo, Wwg, Ss^Vhs, Ss, Ss, Ss, Uh, Uh, Hhd, Hhd, Mm, Xuc, Hhd, Hhd, Ha
Urb, Urb, Urb, Uu, Urb, Urb, Ss, Urb, Ss, Urb, Urb, Urb, Urb, Urb, Urb, Urb^Br\, Sm, Sm, Sm, Sm, Sm, Sm, Sm, Wwf, Wwf, Ss, Wwf, Wwf, Ss, Ss^Vhs, Ss, Ss, Wwf, Chw, Khr, Wwg, Wwg, Wwg, Ss, Wwg, Wwg, Wwg, Wwg, Ss, Ss, Xuc, Xuc, Xuc, Sm, Xuc, Xu, Ha
Urb, Urb, Urb, Urb, Ss, Ss, Wwf, Ss, Wwf, Ss, Sm, Sm, Urb, Urb, Urb, Wwf, Wwf, Wwf^Br\, Ss^Br\, Xuc, Xuc, Sm, Xuc, Sm, Sm, Wwf, Sm, Wwf, Wwf, Ss, Wwf, Wwf, Ss, Chs, Chs, Ss, Wwf, Ss, Sm, Sm, Sm, Sm, Sm, Sm, Sm, Sm, Sm, Sm, Sm^Vhs, Sm, Sm, Xu
Sm, Sm, Sm, Urb, Ss, Wwf, Xos, Wwf, Ss, Ss, Urb, Sm, Urb, Urb, Urb, Urb, Sm, Wwf, Ss, Ss^Br\, Ss, Xuc, Ss, Xuc, Xuc, Sm, Xuc, Sm, Sm, Wwf, Ss, Wwf, Wwf, Ss, Ss, Ss, Sm, Sm, Uu, Uu, Uu, Uu, Uu, Uu, Uu, Sm, Uu, Ss, Ss, Ss, Sm, Sm
Xos, Xos, Xos, Sm, Xos, Xos, Ss, Ss, Urb, Urb, Uu, Urb, Uu^Vu, Urb, Urb, Sm, Wwf, Wwf, Ss, Ss, Ss, Ss^Br\, Ss^Br\, Ss, Xu, Xu, Ss, Xuc, Xuc, Sm, Ss, Ss, Wwf, Ss, Ss, Sm, Sm, Uu, Qxu, Qxu, Qxu, Qxu, Qxu, Qxu, Qxu, Uu, Uu, Ss, Ss, Ss, Sm, Sm
Ss, Ss, Ss, Xos, Ss, Ss, Urb, Urb, Uu, Uu, Xu, Uu, Uu, Uu, Uu, Sm, Wwf, Wwf, Wwf, Wwf, Wwf, Wwf, Wwf, Ss, Xu, Ss, Wwf, Ss, Ss, Xuc, Xuc, Ss, Ss, Wwf, Wwf, Ss, Uu, Uu, Uu, Qxu, Qxu, Qxu, Qxu, Qxu, Qxu, Qxu, Qxu, Uu, Ss, Ss, Ss, Sm
Urb, Urb, Urb, Ss, Urb, Urb, Uu, Uu, Xu, Xu, Xuc, Xuc, Xuc, Xuc, Xuc, Sm, Sm, Sm, Sm, Sm, Sm, Wwf^Vhs, Sm, Ss, Xu, Wwf, Sm^Br\, Wwf, Wwf, Ss, Sm, Xu, Xuc, Ss, Wwf, Ss, Ss, Uu, Qxu, Qxu, Qxu, Qxu, Qxu, Qxu, Qxu, Qxu, Qxu, Uu, Uu, Uu, Ss, Sm
Uu, Urb, Urb^Vo, Urb, Uu, Uu, Xu, Xu, Qxu, Qxu, Qxu, Qxu, Qxu, Qxu, Qxu, Xuc, Xuc, Xuc, Xuc, Xuc, Xuc, Sm, Xuc, Sm, Xuc, Sm, Sm, Sm^Br\, Sm, Wwf, Sm, Sm, Xuc, Ss, Wwf, Wwf, Ss^Vhs, Uu, Uu, Qxu, Qxu, Qxu, Qxu, Qxu, Qxu, Qxu, Uu, Qxu, Uu, Uu, Uu, Ss
Xuc, Uu, Uu, Uu, Xuc, Xuc, Qxu, Qxu, Qxu, Qxu, Iwr, Qxu, Qxu, Qxu, Qxu, Qxu, Qxu, Qxu, Xuc, Hh, Ha^Fma, Xuc, Ms, Xuc, Ha, Xuc, Xuc, Sm, Sm, Wwf, Ss^Br\, Sm, Xuc, Ss, Wwf, Ss, Ss, Uu, Qxu, Qxu, Qxu, Qxu, Qxu, Qxu, Qxu, Qxu, Uu, Uu, Uu, Uu^Vu, Uu, Uu
Qxu, Xuc, Xuc, Xuc, Qxu, Qxu, Iwr, Iwr, Iwr, Iwr, Iwr, Iwr, Iwr, Iwr, Iwr, Qxu, Qxu, Qxu, Xuc, Hh, Ha, Ms, Ha, Ha, Mv, Ha, Ha, Xuc, Sm, Wwf, Wwf, Ss, Xuc, Ss, Ss, Wwf, Ss, Uu, Uu, Qxu, Qxu, Qxu, Qxu, Qxu, Qxu, Qxu, Qxu, Uu, Uu, Uu, Uu, Uu
Qxu, Qxu, Qxu, Qxu, Iwr, Iwr, Cud, Iwr, Cud, Iwr, Iwr, Iwr, Iwr, Iwr, Iwr, Iwr, Iwr, Qxu, Qxu, Xuc, Xuc, Ha, Hh, Mm, Mm, Mm, Ha, Xuc, Sm, Sm, Wwf, Ss, Sm, Xuc, Sm, Wwf, Wwf, Ss, Uh, Qxu, Qxu, Qxu, Qxu, Qxu, Qxu, Qxu, Qxu, Qxu, Uu, Ss, Ss, Ss
Urb, Qxu, Iwr, Iwr, Iwr, Iwr, Iwr, Iwr, Iwr, Iwr, Iwr, Iwr, Iwr, Iwr, Iwr, Iwr, Iwr, Iwr, Iwr, Qxu, Qxu, Xuc, Gs^Ft, Gs^Ft, Gs^Ft, Hh^Vhcr, Hh, Xuc, Xuc, Sm, Wwf, Ss, Ss, Xuc, Sm, Ss, Wwf, Ss, Ss, Uu, Uu, Qxu, Uu, Qxu, Qxu, Qxu, Uu, Uu, Ss, Ss, Sm, Ss
Uu, Qxu^Bs\, Iwr, Iwr, Iwr, Iwr, Iwr^Vo, Iwr, Iwr, Iwr, Qxu, Iwr, Iwr, Iwr, Iwr, Cud, Iwr, Iwr, Iwr, Qxu, Uu, Uu, Ss, Gs^Ft, Ss, Gs^Ft, Gs^Ft, Hh, Xuc, Sm, Sm, Wwf, Ss, Xuc, Xuc, Sm, Ss, Wwf, Wwf, Ss, Sm, Uu, Sm, Uu, Uu, Uu, Ss^Vhs, Ss, Sm, Sm, Xu, Sm
Urb, Qxu, Iwr, Iwr, Iwr, Iwr, Iwr, Iwr, Qxu^Bs|, Qxu, Qxu, Qxu, Qxu^Bs|, Iwr, Iwr, Iwr, Iwr, Iwr, Iwr, Qxu^Bs\, Uu, Uh, Ss, Ss, Wwg, Ss, Ss, Xuc, Sm, Sm, Sm, Wwf, Wwf^Vo, Ss, Xuc, Sm, Sm, Ss, Wwf, Wwf, Wwf, Sm, Wwf, Sm, Sm, Sm, Sm, Sm, Xuc, Xuc, Uu, Xu
Qxu, Qxu, Iwr, Iwr, Cud, Iwr, Iwr, Qxu, Cud, Cud, 2 Kud, Cud, Cud, Qxu, Iwr, Iwr, Cud, Iwr, Iwr, Qxu, Uu, Ss, Wwf, Wwg, Wwg, Wwg, Ss, Ss, Ss, Sm, Wwf, Wwf, Ss, Ss, Xuc, Xu, Xuc, Ss, Wwf, Sm, Sm, Wwf, Sm, Wwf, Wwf, Wwf, Sm, Sm, Xuc, Uu, Ss, Uu
Urb, Qxu, Iwr, Iwr, Iwr, Iwr, Iwr, Qxu, Qxu^Bs|, Cud, Qxu, Cud, Qxu^Bs|, Qxu, Iwr, Iwr, Iwr, Iwr, Iwr, Qxu, Uu, Ss, Ss, Wwf, Wwf, Wwf, Wwf, Wwf, Ss, Ss, Wwf, Ss, Ss, Ss, Xuc, Cud, Xu, Xu, Xu, Wwf, Xuc, Sm, Xu, Sm, Sm, Sm, Xuc, Xuc, Uu, Uu, Ss, Ss
Uu, Qxu, Iwr, Iwr, Iwr, Iwr, Iwr^Vo, Iwr, Iwr, Qxu, Qxu, Qxu, Iwr, Iwr, Iwr, Iwr, Iwr, Iwr, Iwr, Qxu^Bs/, Uu, Ss, Wwf, Wwf, Ss, Ss, Ss, Wwf, Cud, Wwf, Ss, Ss, Sm, Sm, Xuc, Kud, Xuc, Uu, Wwf, Uu, Uu^Br\, Xu, Uu, Xuc, Xuc, Xuc, Uu, Uu, Ss, Ss, Wwg, Wwg
Urb, Qxu^Bs/, Iwr, Iwr, Iwr, Iwr, Iwr, Iwr, Iwr, Iwr, Iwr, Iwr, Iwr, Iwr, Iwr, Cud, Iwr, Iwr, Iwr, Qxu, Uu, Ss, Ss, Wwf, Ss, Wwf, Wwf, Cud, 3 Kud, Cud, Ss, Ss, Sm, Xuc, Urb, Urb, Urb, Wwf, Ss, Wwf, Ss, Uu, Ss, Uu, Uu, Uu, Ss, Uu, Ss^Vo, Ss, Wwf, Wwf
Uu, Qxu, Qxu, Iwr, Iwr, Iwr, Cud, Iwr, Cud, Iwr, Iwr, Iwr, Iwr, Iwr, Iwr, Iwr, Iwr, Iwr, Qxu, Qxu, Qxu, Uu, Ss, Wwf, Wwf, Wwf, Ss, Cud, Cud, Cud, Ss, Sm, Sm, Xuc, Urb, Urb, Urb, Xu, Ss, Wwf, Wwf, Ss, 1 Wwg, Ss^Br\, Ss, Ss, Wwf, Ss, Wwf, Ss, Wwf, Wwg
Uu, Uu, Qxu, Qxu, Qxu, Iwr, Iwr, Iwr, Iwr, Iwr, Iwr, Iwr, Iwr, Iwr, Iwr, Iwr, Qxu, Qxu, Qxu, Qxu, Uu, Uu, Uu, Ss, Wwf, Ss, Ss, Ss, Wwf, Ss, Ss, Sm, Sm, Xuc, Xu, Urb, Xu, Xuc, Ss, Ss, Wwf, Wwf, Wwf, Ss, Wwf, Wwf, Ss, Wwf, Ss, Wwf, Ss, Ss
Uu, Qxu, Uu, Qxu, Qxu, Qxu, Qxu, Iwr, Qxu, Iwr, Iwr, Iwr, Qxu, Iwr, Qxu, Qxu, Qxu, Qxu, Qxu, Qxu, Urb, Urb, Urb, Ss^Bw/, Wwf, Wwf, Wwf, Wwf, Ss, Ss, Sm, Sm, Xuc, Xuc, Urb, Xu, Urb^Vo, Xuc, Xuc, Ss, Ss, Wwg, Wwf, Wwf, Ss, Ss, Sm, Ss^Br\, Sm^Br\, Ss, Uu, Uu
Uu, Uu, Uu, Qxu, Xuc, Qxu, Qxu, Qxu, Qxu, Qxu, Qxu^Bs|, Qxu, Qxu, Qxu, Qxu, Qxu, Uu, Uu, Urb, Urb, Ss, Urb^Vo, Ss, Ss, Wwf, Ss, Ss, Ss, Ss, Ss, Sm, Sm, Xuc, Uu^Uf, Urb, Urb, Urb, Uh, Xuc, Ss, Ss, Ss^Vhs, Ss, Wwg, Ss, Sm, Sm, Sm, Sm, Sm, Sm, Uu
Urb, Urb^Vo, Uu, Uu, Xuc, Xuc, Xuc, Xuc, Xuc, Qxu, Urb, Qxu, Qxu, Qxu, Qxu, Uu, Urb^Vo, Urb, Ss, Ss, Wwf, Ss, Wwf, Wwf, Ss, Ss, Wwf, Ss, Wwf, Ss^Vhs, Ss, Sm, Xuc, Uu, Urb, Urb, Urb, Uu, Xuc, Sm, Sm, Ss, Sm, Ss, Xuc, Sm, Xuc, Sm, Xuc, Sm, Sm, Sm
Urb, Urb, Uu, Uu, Xuc, Xuc, Qxu, Cud, Qxu, Xuc, Urb, Xuc, Qxu, Qxu, Uu, Uu, Uu, Uu, Uu, Ss, Ss, Wwf, Ss, Wwf, Wwf, Wwf, Ss, Wwf, Wwf, Ss, Sm, Sm, Xuc, Uu, Uu, Uu, Uu, Uu, Xuc, Xuc, Xuc, Sm, Xuc, Sm, Xuc, Xuc, Xuc, Xuc, Xuc, Xuc, Xu, Xu
Urb, Urb, Urb, Urb, Urb, Qxu, Urb, Qxu^Bs|, Urb, Urb, Urb, Xuc, Xuc, Qxu, Qxu, Qxu, Uu, Uu, Uu^Uf, Uh, Uh, Ss, Ss, Ss, Ss, Ss, Ss, Ss, Wwf, Ss, Sm, Xuc, Xuc, Xuc, Xuc, Xuc, Xuc, Xuc, Xuc, Xuc, Xuc, Xuc, Xuc, Xuc, Xuc, Xuc, Xuc, Xuc, Xuc, Xuc, Xu, Xu
